1.088861014747762646e+01 1.088861014747762646e+01 1.088861014747762646e+01 1.088861014747762646e+01 1.088861014747762646e+01 1.088861014747762646e+01 1.297679280655742851e+01 2.531372258099227324e+01 4.446171074136233869e+01 6.181344965066297448e+01 7.219876209308588955e+01 6.759611020901610345e+01 4.186252144182306267e+01 2.873990598304915878e+01 1.265414040127489415e+01 1.088861014747762646e+01 1.088861014747762646e+01 1.088861014747762646e+01 1.088861014747762646e+01 1.088861014747762646e+01
1.088861014747762646e+01 1.088861014747762646e+01 1.088861014747762646e+01 1.088861014747762646e+01 1.088861014747762646e+01 1.088861014747762646e+01 1.898624532192540926e+01 2.916349953703209863e+01 5.462287036547145647e+01 7.686712317032599628e+01 8.294311872770731497e+01 7.616838353962739916e+01 5.085501455824217487e+01 2.707095566904435557e+01 1.265414040127489415e+01 1.088861014747762646e+01 1.088861014747762646e+01 1.088861014747762646e+01 1.088861014747762646e+01 1.088861014747762646e+01
1.088861014747762646e+01 1.088861014747762646e+01 1.088861014747762646e+01 1.088861014747762646e+01 1.088861014747762646e+01 1.088861014747762646e+01 2.218480526565863542e+01 3.541455728228826416e+01 5.873846577756897602e+01 8.188195720090044460e+01 9.266461613442805856e+01 7.580259860060492372e+01 4.844127864275660045e+01 2.961605226371991861e+01 1.265414040127489415e+01 1.088861014747762646e+01 1.088861014747762646e+01 1.088861014747762646e+01 1.088861014747762646e+01 1.088861014747762646e+01
1.088861014747762646e+01 1.088861014747762646e+01 1.088861014747762646e+01 1.088861014747762646e+01 1.088861014747762646e+01 1.297679280655742851e+01 2.353716881851157439e+01 4.446171074136233869e+01 6.769048670333923212e+01 8.745025411626610889e+01 9.203995792354338334e+01 7.538575224983350154e+01 4.573935375086551858e+01 2.655265149463724228e+01 1.265414040127489415e+01 1.088861014747762646e+01 1.088861014747762646e+01 1.088861014747762646e+01 1.088861014747762646e+01 1.088861014747762646e+01
1.088861014747762646e+01 1.088861014747762646e+01 1.088861014747762646e+01 1.088861014747762646e+01 1.088861014747762646e+01 1.898624532192540926e+01 2.916349953703209863e+01 5.168298288690168363e+01 7.788224065174028965e+01 8.745025411626610889e+01 8.686999644177959112e+01 6.859286780813724249e+01 4.329695101814689906e+01 2.433328676543170133e+01 1.265414040127489415e+01 1.088861014747762646e+01 1.088861014747762646e+01 1.088861014747762646e+01 1.088861014747762646e+01 1.088861014747762646e+01
1.088861014747762646e+01 1.088861014747762646e+01 1.088861014747762646e+01 1.088861014747762646e+01 1.088861014747762646e+01 2.089100076946766649e+01 3.486484599053040512e+01 5.604722516285772826e+01 8.188195720090044460e+01 1.014768654606644702e+02 9.666675597716454149e+01 6.727140607513875636e+01 4.186252144182306267e+01 2.579693276562437987e+01 1.265414040127489415e+01 1.088861014747762646e+01 1.088861014747762646e+01 1.088861014747762646e+01 1.088861014747762646e+01 1.088861014747762646e+01
1.088861014747762646e+01 1.088861014747762646e+01 1.088861014747762646e+01 1.088861014747762646e+01 1.297679280655742851e+01 2.379786553797185178e+01 4.446171074136233869e+01 6.846609799246083128e+01 9.321057797521244481e+01 1.061917331718615856e+02 9.957466110354205568e+01 7.616838353962739916e+01 4.835766406425123165e+01 2.993339851228013870e+01 2.203289989699594642e+01 1.147854388582445573e+01 1.088861014747762646e+01 1.088861014747762646e+01 1.088861014747762646e+01 1.088861014747762646e+01
1.088861014747762646e+01 1.088861014747762646e+01 1.088861014747762646e+01 1.088861014747762646e+01 1.513667193724102411e+01 2.916349953703209863e+01 5.168298288690168363e+01 8.197363269594195856e+01 1.065077890595537724e+02 1.141578737490830804e+02 1.113891188404837180e+02 9.181800789010860342e+01 5.855870590381934448e+01 4.072251402991292224e+01 2.453099885577250205e+01 1.232314249972932707e+01 1.147854388582445573e+01 1.088861014747762646e+01 1.088861014747762646e+01 1.088861014747762646e+01
1.088861014747762646e+01 1.088861014747762646e+01 1.088861014747762646e+01 1.088861014747762646e+01 1.898624532192540926e+01 3.279836236708239738e+01 5.604722516285772826e+01 9.157916572318288218e+01 1.173902969496717645e+02 1.239997056669139681e+02 1.210708524376180577e+02 9.957466110354205568e+01 8.168445796081245192e+01 6.117098969109301265e+01 4.021993488090814139e+01 2.453099885577250205e+01 1.147854388582445573e+01 1.088861014747762646e+01 1.088861014747762646e+01 1.088861014747762646e+01
1.088861014747762646e+01 1.088861014747762646e+01 1.088861014747762646e+01 1.088861014747762646e+01 2.218480526565863542e+01 4.068791641908065770e+01 6.769048670333923212e+01 9.471767423987976997e+01 1.128665915604702690e+02 1.204686494619759287e+02 1.198382285740780304e+02 1.088833621269854746e+02 9.574027468639023652e+01 7.616838353962739916e+01 4.835766406425123165e+01 2.873990598304915878e+01 1.265414040127489415e+01 1.088861014747762646e+01 1.088861014747762646e+01 1.088861014747762646e+01
1.088861014747762646e+01 1.088861014747762646e+01 1.088861014747762646e+01 1.297679280655742851e+01 2.353716881851157439e+01 4.446171074136233869e+01 6.769048670333923212e+01 9.471767423987976997e+01 1.061461833909342545e+02 1.047738185740964951e+02 1.113674589718777383e+02 1.059585417085853436e+02 1.011132893369093040e+02 8.979513293131499552e+01 5.767017738979565422e+01 2.873990598304915878e+01 1.265414040127489415e+01 1.088861014747762646e+01 1.088861014747762646e+01 1.088861014747762646e+01
1.088861014747762646e+01 1.088861014747762646e+01 1.088861014747762646e+01 1.513667193724102411e+01 2.661150548290510187e+01 4.883133956083237592e+01 7.386773713124969731e+01 8.745025411626610889e+01 9.620845608377416625e+01 8.654024352948380283e+01 8.753679061281403051e+01 9.742630944814564486e+01 1.011132893369093040e+02 9.029288949445700041e+01 5.767017738979565422e+01 2.961605226371991861e+01 1.265414040127489415e+01 1.088861014747762646e+01 1.088861014747762646e+01 1.088861014747762646e+01
1.088861014747762646e+01 1.088861014747762646e+01 1.088861014747762646e+01 1.898624532192540926e+01 3.289131668065730452e+01 5.545195109652075161e+01 8.188195720090044460e+01 8.820566072447434181e+01 8.351984876946342240e+01 7.205926305131100662e+01 7.910866619247029519e+01 9.471767423987976997e+01 9.314567550438434296e+01 8.274219550687182334e+01 5.767017738979565422e+01 2.961605226371991861e+01 1.265414040127489415e+01 1.088861014747762646e+01 1.088861014747762646e+01 1.088861014747762646e+01
1.088861014747762646e+01 1.088861014747762646e+01 1.088861014747762646e+01 2.089100076946766649e+01 2.984799920974266385e+01 5.579125899993440640e+01 7.953049889747252621e+01 8.385551006633727411e+01 8.203266977252577874e+01 7.105529491571397216e+01 7.381724080597643933e+01 9.471767423987976997e+01 9.314567550438434296e+01 8.274219550687182334e+01 5.767017738979565422e+01 2.961605226371991861e+01 1.265414040127489415e+01 1.088861014747762646e+01 1.088861014747762646e+01 1.088861014747762646e+01
1.088861014747762646e+01 1.088861014747762646e+01 1.088861014747762646e+01 1.898624532192540926e+01 3.388431276105094980e+01 5.762780987772501362e+01 7.953049889747252621e+01 8.866744005033477549e+01 8.168445796081245192e+01 7.198282591695618748e+01 7.776409381323520620e+01 9.722462619059621147e+01 9.610637322158983409e+01 8.274219550687182334e+01 5.297500169942210135e+01 2.961605226371991861e+01 1.265414040127489415e+01 1.088861014747762646e+01 1.088861014747762646e+01 1.088861014747762646e+01
1.088861014747762646e+01 1.088861014747762646e+01 1.088861014747762646e+01 1.513667193724102411e+01 2.853193647683530543e+01 4.914956161446551164e+01 7.992423938359198132e+01 9.076925745594560624e+01 8.934030866358358480e+01 8.362876071596043914e+01 9.708820802314477305e+01 9.909308497485466205e+01 9.203995792354338334e+01 7.538575224983350154e+01 4.573935375086551858e+01 2.655265149463724228e+01 1.265414040127489415e+01 1.088861014747762646e+01 1.088861014747762646e+01 1.088861014747762646e+01
1.088861014747762646e+01 1.088861014747762646e+01 1.088861014747762646e+01 1.297679280655742851e+01 2.749142178355513977e+01 4.914956161446551164e+01 6.168811268288132510e+01 8.753679061281403051e+01 9.076925745594560624e+01 9.946822208406399568e+01 1.009523659862675942e+02 9.610637322158983409e+01 8.575386017525627835e+01 5.891354129768262737e+01 3.829441719014133838e+01 2.368249920005213127e+01 1.265414040127489415e+01 1.088861014747762646e+01 1.088861014747762646e+01 1.088861014747762646e+01
1.088861014747762646e+01 1.088861014747762646e+01 1.088861014747762646e+01 1.088861014747762646e+01 2.349478139652563158e+01 3.437483763177673524e+01 5.902128706191970764e+01 7.910866619247029519e+01 8.559466602443458783e+01 9.742630944814564486e+01 9.620845608377416625e+01 8.875844790383006000e+01 7.230960441305835218e+01 4.663605049050162421e+01 3.074442366493345347e+01 1.983670545595346368e+01 1.088861014747762646e+01 1.088861014747762646e+01 1.088861014747762646e+01 1.088861014747762646e+01
1.088861014747762646e+01 1.088861014747762646e+01 1.088861014747762646e+01 1.088861014747762646e+01 1.088861014747762646e+01 2.820268600374796009e+01 3.818726357631852153e+01 5.688312356916659951e+01 6.553764036369207702e+01 7.893253801936874936e+01 7.887602757999994196e+01 6.606404313207930556e+01 5.316887009454573132e+01 3.556480404205751000e+01 2.368249920005213127e+01 1.265414040127489415e+01 1.088861014747762646e+01 1.088861014747762646e+01 1.088861014747762646e+01 1.088861014747762646e+01
1.088861014747762646e+01 1.088861014747762646e+01 1.088861014747762646e+01 1.088861014747762646e+01 1.088861014747762646e+01 1.837856612832709757e+01 2.820268600374796009e+01 3.818726357631852153e+01 4.880211454508854274e+01 5.113696424142695918e+01 5.113696424142695918e+01 4.089225687133732379e+01 3.556480404205751000e+01 2.521641010348762535e+01 1.265414040127489415e+01 1.088861014747762646e+01 1.088861014747762646e+01 1.088861014747762646e+01 1.088861014747762646e+01 1.088861014747762646e+01
