1.108217142411705503e+01 1.108217142411705503e+01 1.108217142411705503e+01 1.108217142411705503e+01 1.108217142411705503e+01 1.108217142411705503e+01 1.108217142411705503e+01 1.108217142411705503e+01 1.108217142411705503e+01 1.108217142411705503e+01 1.108217142411705503e+01 1.108217142411705503e+01 1.108217142411705503e+01 1.108217142411705503e+01 1.898290830843226118e+01 2.883005383128201160e+01 4.396797881515495021e+01 4.868023669325731362e+01 4.929010723282313222e+01 3.516279279481085496e+01
1.108217142411705503e+01 1.108217142411705503e+01 1.108217142411705503e+01 1.108217142411705503e+01 1.108217142411705503e+01 1.298417641307441528e+01 1.837134595259106362e+01 2.282980076051211427e+01 2.435978664769612578e+01 2.169233731671396370e+01 1.108217142411705503e+01 1.108217142411705503e+01 1.108217142411705503e+01 1.513667193724102411e+01 2.427424062440862329e+01 4.055479307451389559e+01 5.752568097253296031e+01 6.283469650076322921e+01 5.441887939095920501e+01 4.186158727219585529e+01
1.108217142411705503e+01 1.108217142411705503e+01 1.108217142411705503e+01 1.108217142411705503e+01 1.108217142411705503e+01 1.990596944687126424e+01 2.698167300364075416e+01 3.334035718118192193e+01 3.261402268888410561e+01 2.560690560556014361e+01 2.045274082323325260e+01 1.108217142411705503e+01 1.108217142411705503e+01 1.990596944687126424e+01 3.571732647487553436e+01 5.319549584881318083e+01 6.633780463916643555e+01 7.348030181061091071e+01 5.756585189087502386e+01 3.906371260887143393e+01
1.108217142411705503e+01 1.108217142411705503e+01 1.108217142411705503e+01 1.108217142411705503e+01 1.898290830843226118e+01 2.883005383128201160e+01 4.460898879007234541e+01 4.868023669325731362e+01 4.929010723282313222e+01 3.972285031012879841e+01 2.341591879747660698e+01 1.539791877586744562e+01 1.898290830843226118e+01 2.825482377842292792e+01 4.340745079491230740e+01 6.269370575654928501e+01 7.461294303034624420e+01 6.753878430601815808e+01 5.176819011168253581e+01 3.417961769261327021e+01
1.108217142411705503e+01 1.108217142411705503e+01 1.108217142411705503e+01 1.513667193724102411e+01 2.770109289207225345e+01 4.317187314353883210e+01 5.747846036044393259e+01 6.489454775109602735e+01 6.183646466155793320e+01 4.186158727219585529e+01 2.488187746232800990e+01 1.724523745814553166e+01 2.237693562265769387e+01 3.486484599053040512e+01 5.319549584881318083e+01 7.084553889298001650e+01 7.958463983829553001e+01 6.777078756221685296e+01 4.277353276790253744e+01 2.588607311622529039e+01
1.108217142411705503e+01 1.108217142411705503e+01 1.513667193724102411e+01 2.427424062440862329e+01 3.685834295612110623e+01 5.752568097253296031e+01 7.279724150828415929e+01 6.817585272941408903e+01 5.756585189087502386e+01 3.883925857525532166e+01 2.368578414005839150e+01 2.100285862555452709e+01 2.743693270755588998e+01 4.317187314353883210e+01 6.269370575654928501e+01 7.461294303034624420e+01 6.863060358112838344e+01 5.236774628605353143e+01 3.417961769261327021e+01 2.351640075703397770e+01
1.108217142411705503e+01 1.108217142411705503e+01 1.990596944687126424e+01 3.571732647487553436e+01 5.319549584881318083e+01 7.084553889298001650e+01 7.461294303034624420e+01 6.753878430601815808e+01 5.236774628605353143e+01 3.324720773253786632e+01 2.511383496485400713e+01 2.237693562265769387e+01 3.681348424584469115e+01 5.319549584881318083e+01 7.084553889298001650e+01 7.461294303034624420e+01 6.307102426003083195e+01 4.277353276790253744e+01 2.857236678764681770e+01 2.009839063269585679e+01
1.108217142411705503e+01 1.898290830843226118e+01 2.883005383128201160e+01 4.787779068620908873e+01 6.269370575654928501e+01 7.461294303034624420e+01 7.705447772356536973e+01 5.925722197578600969e+01 4.113143548246773662e+01 2.789633055775786374e+01 2.100285862555452709e+01 3.001704739762952556e+01 4.949365291902179820e+01 6.269370575654928501e+01 7.461294303034624420e+01 6.863060358112838344e+01 5.580650486288243428e+01 3.422888894622538913e+01 2.351640075703397770e+01 1.264970591794865307e+01
1.108217142411705503e+01 2.379922412839371049e+01 3.751090038074672606e+01 6.150416641924906003e+01 7.502348307834790830e+01 8.524553821199205572e+01 6.863060358112838344e+01 5.176819011168253581e+01 3.656100763659083697e+01 2.516931611426581128e+01 2.811842430184293562e+01 4.055479307451389559e+01 6.150416641924906003e+01 7.813123786850424324e+01 7.642600599506538117e+01 6.689144053798564471e+01 4.656666800415509044e+01 2.789633055775786374e+01 2.009839063269585679e+01 1.108217142411705503e+01
1.898290830843226118e+01 3.058303075517601854e+01 5.211856397322731027e+01 7.921109360082573403e+01 9.095429735347887856e+01 8.737773010171657972e+01 7.421072814413324181e+01 5.329084466681283772e+01 4.929010723282313222e+01 3.825276850249189664e+01 4.415113662703367226e+01 5.724941330558358032e+01 7.928897002604557542e+01 8.784210162703561764e+01 8.219170294450923109e+01 6.700634300850298075e+01 4.347673973496277711e+01 2.368578414005839150e+01 1.264970591794865307e+01 1.108217142411705503e+01
1.990596944687126424e+01 3.627013378260618026e+01 5.998548665701476779e+01 8.473706218398866952e+01 1.034502430473207681e+02 9.666675597716454149e+01 8.375074020428093036e+01 7.056676616106132371e+01 7.056676616106132371e+01 6.206578469045618363e+01 7.451852821981542263e+01 8.242263072285476255e+01 9.707224727555509958e+01 9.847726800555551563e+01 8.674695502195203289e+01 6.112764820676535749e+01 3.906371260887143393e+01 2.165096377748534451e+01 1.264970591794865307e+01 1.108217142411705503e+01
2.089100076946766649e+01 4.048534321612612530e+01 6.808002006788251492e+01 9.675425204012546487e+01 1.082346948981237489e+02 1.150031293665479382e+02 9.439061252242548505e+01 9.691760657841794568e+01 9.691760657841794568e+01 9.691760657841794568e+01 9.734201172242900668e+01 1.047339150126608445e+02 1.071966218848032071e+02 9.755898227151203628e+01 8.295820827485614757e+01 5.891354129768262737e+01 3.219025984875912627e+01 2.165096377748534451e+01 1.264970591794865307e+01 1.108217142411705503e+01
2.085704346369211137e+01 3.763479976630730306e+01 6.168811268288132510e+01 8.570441209213987577e+01 1.030640214914672868e+02 1.077001266923646341e+02 1.106942551526976928e+02 9.945000289393640003e+01 9.945000289393640003e+01 1.153737889347948027e+02 1.153737889347948027e+02 1.145428129290725252e+02 1.054439181075772183e+02 9.104041633965269398e+01 6.893120094374867790e+01 4.439348330104167673e+01 2.857236678764681770e+01 2.009839063269585679e+01 1.108217142411705503e+01 1.108217142411705503e+01
2.085704346369211137e+01 2.820577677331711897e+01 4.954931111420673773e+01 6.307927180890533236e+01 8.643849828145120284e+01 8.643849828145120284e+01 9.115313933642123345e+01 9.115313933642123345e+01 1.030640214914672868e+02 1.113674589718777383e+02 1.170325090941461070e+02 1.093766372396100195e+02 9.730354654791858593e+01 7.040647370511656788e+01 4.962800359191603405e+01 3.433583796355577533e+01 2.377099702667949899e+01 1.264970591794865307e+01 1.108217142411705503e+01 1.108217142411705503e+01
1.108217142411705503e+01 2.469147365312298703e+01 3.379701954420713861e+01 4.560082086381255095e+01 5.670634611441236927e+01 5.847446684007483242e+01 6.533409723411541847e+01 7.265893438361473500e+01 8.559466602443458783e+01 9.389290032684974108e+01 1.062784662587180549e+02 1.012120714734326157e+02 7.537962589176542849e+01 5.501911200687596448e+01 3.433583796355577533e+01 2.377099702667949899e+01 1.264970591794865307e+01 1.108217142411705503e+01 1.108217142411705503e+01 1.108217142411705503e+01
1.108217142411705503e+01 1.108217142411705503e+01 2.290990957956565310e+01 2.846196832584900704e+01 2.846196832584900704e+01 3.660742514209734111e+01 4.618183022731054876e+01 5.640053915948501384e+01 7.068830606338596567e+01 8.668573036081994587e+01 9.522539161452294820e+01 8.451921938311346594e+01 5.891354129768262737e+01 3.689824540952297838e+01 2.377099702667949899e+01 1.264970591794865307e+01 1.108217142411705503e+01 1.108217142411705503e+01 1.108217142411705503e+01 1.108217142411705503e+01
1.108217142411705503e+01 1.108217142411705503e+01 1.108217142411705503e+01 1.837856612832709757e+01 1.837856612832709757e+01 2.290990957956565310e+01 2.865482208433423494e+01 4.535191367572409860e+01 6.915092191403124389e+01 8.444901044460867467e+01 8.353449982686251474e+01 6.777078756221685296e+01 4.573935375086551858e+01 2.588607311622529039e+01 2.009839063269585679e+01 1.108217142411705503e+01 1.108217142411705503e+01 1.108217142411705503e+01 1.108217142411705503e+01 1.108217142411705503e+01
1.108217142411705503e+01 1.108217142411705503e+01 1.108217142411705503e+01 1.108217142411705503e+01 1.108217142411705503e+01 1.460665488214961449e+01 2.529381281481597910e+01 4.445326193010816951e+01 6.769048670333923212e+01 8.381243850540641915e+01 7.360365238124305165e+01 5.580650486288243428e+01 3.324720773253786632e+01 2.351640075703397770e+01 1.264970591794865307e+01 1.108217142411705503e+01 1.108217142411705503e+01 1.108217142411705503e+01 1.108217142411705503e+01 1.108217142411705503e+01
1.108217142411705503e+01 1.108217142411705503e+01 1.108217142411705503e+01 1.108217142411705503e+01 1.108217142411705503e+01 1.298417641307441528e+01 2.539091821392638337e+01 4.098916447791744844e+01 6.156230710313367638e+01 7.022356632614358318e+01 5.887490905342765046e+01 4.093091012588290312e+01 2.588607311622529039e+01 1.264970591794865307e+01 1.108217142411705503e+01 1.108217142411705503e+01 1.108217142411705503e+01 1.108217142411705503e+01 1.108217142411705503e+01 1.108217142411705503e+01
1.108217142411705503e+01 1.108217142411705503e+01 1.108217142411705503e+01 1.108217142411705503e+01 1.108217142411705503e+01 1.298417641307441528e+01 2.493715474313448865e+01 3.485317122788086408e+01 4.691907191434188462e+01 5.229700022406023407e+01 4.488947653655188219e+01 2.952859902607908893e+01 2.009839063269585679e+01 1.108217142411705503e+01 1.108217142411705503e+01 1.108217142411705503e+01 1.108217142411705503e+01 1.108217142411705503e+01 1.108217142411705503e+01 1.108217142411705503e+01
