1.083712370998119390e+01 1.083712370998119390e+01 1.083712370998119390e+01 1.083712370998119390e+01 1.083712370998119390e+01 1.083712370998119390e+01 1.988600114128365703e+01 3.158377771282566115e+01 5.079764962848646093e+01 6.406487133881421414e+01 7.895148659788326029e+01 8.732450561560712288e+01 8.732450561560712288e+01 8.732450561560712288e+01 7.056676616106132371e+01 5.855870590381934448e+01 4.062938245188333042e+01 2.873678418557006609e+01 1.387317205034302425e+01 1.146876266095296337e+01
1.083712370998119390e+01 1.083712370998119390e+01 1.083712370998119390e+01 1.083712370998119390e+01 1.083712370998119390e+01 1.383910652264938435e+01 2.578301684661517257e+01 4.339482970803001649e+01 6.564581531526536651e+01 9.157916572318288218e+01 1.119329485276547729e+02 1.153864325128025143e+02 1.153864325128025143e+02 1.153864325128025143e+02 9.443594521599244729e+01 8.732450561560712288e+01 6.056110159603375820e+01 4.189624614473882502e+01 2.873678418557006609e+01 1.195592271032482934e+01
1.083712370998119390e+01 1.083712370998119390e+01 1.083712370998119390e+01 1.083712370998119390e+01 1.146876266095296337e+01 1.898624532192540926e+01 2.999694634808318838e+01 5.503662743889419318e+01 7.921109360082573403e+01 1.065077890595537724e+02 1.227757589341093336e+02 1.311685092665182992e+02 1.311685092665182992e+02 1.311685092665182992e+02 1.311685092665182992e+02 1.153864325128025143e+02 8.865565298908497027e+01 5.855870590381934448e+01 4.127383045923090776e+01 2.273536889621458457e+01
1.083712370998119390e+01 1.083712370998119390e+01 1.083712370998119390e+01 1.146876266095296337e+01 1.146876266095296337e+01 2.354237111229262425e+01 3.734713248572933253e+01 7.061408389157361398e+01 9.474746312504508694e+01 1.123088922022128031e+02 1.227757589341093336e+02 1.293900024298778249e+02 1.293900024298778249e+02 1.269256963758785446e+02 1.311685092665182992e+02 1.199650462634487127e+02 1.104616962682486445e+02 7.642422032014707156e+01 5.948575465942285945e+01 2.873678418557006609e+01
1.083712370998119390e+01 1.083712370998119390e+01 1.083712370998119390e+01 1.083712370998119390e+01 1.988600114128365703e+01 3.158377771282566115e+01 5.503662743889419318e+01 7.721115383985404890e+01 1.065077890595537724e+02 1.162512036952095968e+02 1.091253887173131005e+02 1.080134444676395162e+02 1.077570332667440738e+02 1.152507758983520745e+02 1.248262428518703757e+02 1.311685092665182992e+02 1.104616962682486445e+02 9.359152908523493863e+01 6.117098969109301265e+01 4.185368550760254180e+01
1.083712370998119390e+01 1.083712370998119390e+01 1.146876266095296337e+01 1.898624532192540926e+01 2.926199057811667004e+01 4.339482970803001649e+01 7.061408389157361398e+01 9.474746312504508694e+01 1.095888092714749860e+02 1.091253887173131005e+02 9.405771763963140586e+01 8.322602232613294859e+01 7.847273512744881430e+01 9.391157656504599061e+01 1.077570332667440738e+02 1.248262428518703757e+02 1.199650462634487127e+02 1.104616962682486445e+02 7.616838353962739916e+01 5.008391477172821737e+01
1.083712370998119390e+01 1.146876266095296337e+01 1.513668416285235452e+01 2.354237111229262425e+01 3.843342569933732733e+01 6.406487133881421414e+01 9.157916572318288218e+01 1.095888092714749860e+02 1.115259503167220032e+02 9.405771763963140586e+01 7.211106124425845110e+01 5.278743873932499042e+01 5.143512395634192558e+01 6.155467068425413402e+01 8.570441209213987577e+01 1.143101736728909685e+02 1.248262428518703757e+02 1.104616962682486445e+02 9.029530237411593419e+01 6.039662771986459688e+01
1.083712370998119390e+01 1.083712370998119390e+01 1.988600114128365703e+01 3.571096479776888799e+01 5.829088487273489960e+01 8.473706218398866952e+01 1.010303985757471139e+02 1.162512036952095968e+02 1.056299445036555511e+02 8.054866492259111510e+01 5.236081561962652131e+01 3.964832289000969467e+01 2.846196832584900704e+01 4.832897772369363310e+01 7.068830606338596567e+01 1.014553585094081143e+02 1.248262428518703757e+02 1.199650462634487127e+02 9.927297642551383206e+01 6.117098969109301265e+01
1.146876266095296337e+01 1.898624532192540926e+01 2.999694634808318838e+01 5.079764962848646093e+01 7.721115383985404890e+01 1.010303985757471139e+02 1.140617705230831405e+02 1.091253887173131005e+02 9.193040739172322162e+01 6.389970362063299092e+01 3.917779763357049205e+01 2.521641010348762535e+01 2.094251940520386768e+01 2.904611778390922439e+01 5.492454046883134566e+01 8.570441209213987577e+01 1.110955863975458726e+02 1.199650462634487127e+02 1.104616962682486445e+02 7.616838353962739916e+01
1.146876266095296337e+01 2.354237111229262425e+01 3.734713248572933253e+01 6.564581531526536651e+01 9.385833381479282878e+01 1.095888092714749860e+02 1.115259503167220032e+02 9.458918395359897602e+01 7.296510339877983142e+01 4.663605049050162421e+01 3.074442366493345347e+01 1.922802374772071232e+01 1.911084263676563211e+01 2.721266295227543353e+01 4.914956161446551164e+01 8.397629004977790146e+01 1.110955863975458726e+02 1.182168593831032553e+02 1.056299445036555511e+02 7.761506723706115451e+01
1.898624532192540926e+01 3.158377771282566115e+01 5.503662743889419318e+01 7.721115383985404890e+01 1.010303985757471139e+02 1.115259503167220032e+02 1.056299445036555511e+02 8.054866492259111510e+01 5.887490905342765046e+01 3.425671949316976850e+01 2.101336898524806429e+01 1.266471156661624953e+01 1.898624532192540926e+01 2.999694634808318838e+01 5.545195109652075161e+01 8.397629004977790146e+01 1.065077890595537724e+02 1.162512036952095968e+02 9.927297642551383206e+01 7.025606238670106052e+01
2.354237111229262425e+01 3.734713248572933253e+01 7.061408389157361398e+01 9.474746312504508694e+01 1.095888092714749860e+02 1.049626226662352622e+02 9.193040739172322162e+01 6.293970405345054075e+01 4.113552921372583882e+01 2.553674974168561107e+01 1.779840041986890142e+01 1.540840086842926127e+01 1.988600114128365703e+01 3.734713248572933253e+01 6.149719992180443029e+01 9.157916572318288218e+01 1.063564951515494386e+02 1.091253887173131005e+02 9.193040739172322162e+01 5.892012099175287432e+01
2.999694634808318838e+01 5.094804763391125135e+01 7.721115383985404890e+01 1.065077890595537724e+02 1.162512036952095968e+02 1.043334663518753871e+02 7.532092102791585830e+01 4.663605049050162421e+01 2.986381668141012113e+01 2.049998912139052720e+01 2.068701890639276186e+01 2.309587474134727003e+01 3.717856953183331825e+01 5.079764962848646093e+01 7.721115383985404890e+01 1.010303985757471139e+02 1.071966218848032071e+02 9.888486620411501349e+01 7.761506723706115451e+01 4.663605049050162421e+01
3.546508023773436946e+01 6.396585113467280337e+01 9.157916572318288218e+01 1.119329485276547729e+02 1.146139300820768057e+02 9.668714589495800737e+01 6.618329767595034241e+01 4.119986646560785459e+01 3.067149331317079231e+01 2.516348702404582127e+01 3.205041445803752964e+01 3.793701166723663931e+01 5.802503156858293210e+01 7.310254497290635811e+01 9.710724812454957089e+01 1.057781382861092965e+02 1.113231497481248056e+02 9.193040739172322162e+01 6.389970362063299092e+01 3.917779763357049205e+01
4.068040303065372854e+01 7.360005091671919786e+01 1.010303985757471139e+02 1.227757589341093336e+02 1.199650462634487127e+02 9.927297642551383206e+01 7.616838353962739916e+01 5.855870590381934448e+01 4.518974733151245005e+01 4.574225941216437974e+01 5.482696334956748530e+01 6.579204492661052939e+01 7.895148659788326029e+01 9.710724812454957089e+01 1.095888092714749860e+02 1.115259503167220032e+02 9.888486620411501349e+01 7.532092102791585830e+01 4.663605049050162421e+01 2.655180726855720152e+01
4.046336383232158340e+01 7.360005091671919786e+01 1.014553585094081143e+02 1.248262428518703757e+02 1.199650462634487127e+02 1.104616962682486445e+02 8.865565298908497027e+01 7.056676616106132371e+01 7.451852821981542263e+01 7.451852821981542263e+01 7.895148659788326029e+01 9.710724812454957089e+01 1.029133232995054783e+02 1.095888092714749860e+02 1.115259503167220032e+02 1.091253887173131005e+02 8.054866492259111510e+01 5.887490905342765046e+01 3.425671949316976850e+01 2.101336898524806429e+01
3.763479976630730306e+01 5.579125899993440640e+01 9.391157656504599061e+01 1.110955863975458726e+02 1.248262428518703757e+02 1.199650462634487127e+02 1.153864325128025143e+02 1.045324252040906430e+02 9.693757081034097212e+01 1.047339150126608445e+02 1.047339150126608445e+02 1.140617705230831405e+02 1.115259503167220032e+02 1.115259503167220032e+02 1.008011529288082642e+02 8.461010262780149560e+01 5.887490905342765046e+01 3.964832289000969467e+01 2.553674974168561107e+01 1.398769667877241574e+01
2.749142178355513977e+01 4.956418249588872982e+01 8.468950835147873590e+01 9.764740920362447696e+01 1.248262428518703757e+02 1.269256963758785446e+02 1.269256963758785446e+02 1.149212738430376248e+02 1.153864325128025143e+02 1.140617705230831405e+02 1.162512036952095968e+02 1.115259503167220032e+02 1.030575491903378520e+02 9.325902901775285159e+01 7.346421039204300030e+01 5.278743873932499042e+01 3.964832289000969467e+01 2.553674974168561107e+01 1.837888617728035356e+01 1.266471156661624953e+01
2.090783292994696296e+01 3.763479976630730306e+01 5.902128706191970764e+01 7.661949822627201456e+01 9.391157656504599061e+01 1.077570332667440738e+02 1.063904798206014277e+02 1.122386556625703662e+02 1.122386556625703662e+02 1.122386556625703662e+02 1.080134444676395162e+02 9.405771763963140586e+01 8.322602232613294859e+01 6.606404313207930556e+01 4.899663985637544528e+01 3.605078999462622846e+01 2.521641010348762535e+01 1.837888617728035356e+01 1.266471156661624953e+01 1.174468508189985627e+01
1.393458126591851709e+01 2.629631638515819958e+01 3.661064988801934561e+01 5.104127187800575882e+01 6.155467068425413402e+01 7.832164830691115753e+01 8.226881104641580578e+01 8.322602232613294859e+01 8.322602232613294859e+01 8.322602232613294859e+01 8.322602232613294859e+01 7.172275807440840367e+01 5.027458216561596061e+01 4.088479901846596931e+01 3.007228665707719273e+01 2.101336898524806429e+01 1.266471156661624953e+01 1.266471156661624953e+01 1.174468508189985627e+01 1.083712370998119390e+01
