1.363681225856108448e+01 1.363681225856108448e+01 1.363681225856108448e+01 1.363681225856108448e+01 1.363681225856108448e+01 1.263120930571081857e+01 2.024262848225557221e+01 0.000000000000000000e+00 0.000000000000000000e+00 0.000000000000000000e+00 0.000000000000000000e+00 0.000000000000000000e+00 0.000000000000000000e+00 0.000000000000000000e+00 2.377553471365646942e+01 1.758869351964325745e+01 1.277792403912890684e+01 1.363681225856108448e+01 1.363681225856108448e+01 1.363681225856108448e+01
1.363681225856108448e+01 1.363681225856108448e+01 1.363681225856108448e+01 1.363681225856108448e+01 1.263120930571081857e+01 1.472648456644762760e+01 1.914330839257968009e+01 0.000000000000000000e+00 0.000000000000000000e+00 0.000000000000000000e+00 0.000000000000000000e+00 0.000000000000000000e+00 0.000000000000000000e+00 0.000000000000000000e+00 2.197348011732145778e+01 1.758869351964325745e+01 1.363681225856108448e+01 1.363681225856108448e+01 1.363681225856108448e+01 1.363681225856108448e+01
1.363681225856108448e+01 1.363681225856108448e+01 1.363681225856108448e+01 1.363681225856108448e+01 1.346185382475593961e+01 2.024262848225557221e+01 0.000000000000000000e+00 0.000000000000000000e+00 0.000000000000000000e+00 0.000000000000000000e+00 0.000000000000000000e+00 0.000000000000000000e+00 0.000000000000000000e+00 0.000000000000000000e+00 1.758869351964325745e+01 1.277792403912890684e+01 1.363681225856108448e+01 1.363681225856108448e+01 1.363681225856108448e+01 1.363681225856108448e+01
1.363681225856108448e+01 1.363681225856108448e+01 1.363681225856108448e+01 1.263120930571081857e+01 1.503593971151075692e+01 1.914330839257968009e+01 0.000000000000000000e+00 0.000000000000000000e+00 0.000000000000000000e+00 0.000000000000000000e+00 0.000000000000000000e+00 0.000000000000000000e+00 0.000000000000000000e+00 2.197348011732145778e+01 1.758869351964325745e+01 1.310604600107523687e+01 1.277792403912890684e+01 1.277792403912890684e+01 1.263120930571081857e+01 1.363681225856108448e+01
1.363681225856108448e+01 1.363681225856108448e+01 1.363681225856108448e+01 1.346185382475593961e+01 2.024262848225557221e+01 0.000000000000000000e+00 0.000000000000000000e+00 0.000000000000000000e+00 0.000000000000000000e+00 0.000000000000000000e+00 0.000000000000000000e+00 0.000000000000000000e+00 0.000000000000000000e+00 2.197348011732145778e+01 1.873440249320861994e+01 2.024262848225557221e+01 1.503593971151075692e+01 1.758869351964325745e+01 1.310604600107523687e+01 1.263120930571081857e+01
1.363681225856108448e+01 1.363681225856108448e+01 1.363681225856108448e+01 1.503593971151075692e+01 1.914330839257968009e+01 0.000000000000000000e+00 0.000000000000000000e+00 0.000000000000000000e+00 0.000000000000000000e+00 0.000000000000000000e+00 0.000000000000000000e+00 0.000000000000000000e+00 0.000000000000000000e+00 0.000000000000000000e+00 0.000000000000000000e+00 0.000000000000000000e+00 0.000000000000000000e+00 2.274433451129154093e+01 1.758869351964325745e+01 1.277792403912890684e+01
1.363681225856108448e+01 1.363681225856108448e+01 1.263120930571081857e+01 2.024262848225557221e+01 0.000000000000000000e+00 0.000000000000000000e+00 0.000000000000000000e+00 0.000000000000000000e+00 0.000000000000000000e+00 0.000000000000000000e+00 0.000000000000000000e+00 0.000000000000000000e+00 0.000000000000000000e+00 0.000000000000000000e+00 0.000000000000000000e+00 0.000000000000000000e+00 0.000000000000000000e+00 0.000000000000000000e+00 2.274433451129154093e+01 1.758869351964325745e+01
1.363681225856108448e+01 1.363681225856108448e+01 1.346185382475593961e+01 1.914330839257968009e+01 0.000000000000000000e+00 0.000000000000000000e+00 0.000000000000000000e+00 0.000000000000000000e+00 0.000000000000000000e+00 0.000000000000000000e+00 0.000000000000000000e+00 0.000000000000000000e+00 0.000000000000000000e+00 0.000000000000000000e+00 0.000000000000000000e+00 0.000000000000000000e+00 0.000000000000000000e+00 0.000000000000000000e+00 0.000000000000000000e+00 2.274433451129154093e+01
1.363681225856108448e+01 1.263120930571081857e+01 1.503593971151075692e+01 2.180729880015501365e+01 0.000000000000000000e+00 0.000000000000000000e+00 0.000000000000000000e+00 0.000000000000000000e+00 0.000000000000000000e+00 0.000000000000000000e+00 0.000000000000000000e+00 0.000000000000000000e+00 0.000000000000000000e+00 0.000000000000000000e+00 0.000000000000000000e+00 0.000000000000000000e+00 0.000000000000000000e+00 0.000000000000000000e+00 0.000000000000000000e+00 2.197348011732145778e+01
1.363681225856108448e+01 1.346185382475593961e+01 2.024262848225557221e+01 0.000000000000000000e+00 0.000000000000000000e+00 0.000000000000000000e+00 0.000000000000000000e+00 0.000000000000000000e+00 0.000000000000000000e+00 0.000000000000000000e+00 0.000000000000000000e+00 0.000000000000000000e+00 0.000000000000000000e+00 0.000000000000000000e+00 0.000000000000000000e+00 0.000000000000000000e+00 0.000000000000000000e+00 0.000000000000000000e+00 0.000000000000000000e+00 0.000000000000000000e+00
1.363681225856108448e+01 1.503593971151075692e+01 2.595199756788734646e+01 0.000000000000000000e+00 0.000000000000000000e+00 0.000000000000000000e+00 0.000000000000000000e+00 0.000000000000000000e+00 0.000000000000000000e+00 0.000000000000000000e+00 0.000000000000000000e+00 0.000000000000000000e+00 0.000000000000000000e+00 0.000000000000000000e+00 0.000000000000000000e+00 0.000000000000000000e+00 0.000000000000000000e+00 0.000000000000000000e+00 0.000000000000000000e+00 0.000000000000000000e+00
1.363681225856108448e+01 1.503593971151075692e+01 2.180729880015501365e+01 0.000000000000000000e+00 0.000000000000000000e+00 0.000000000000000000e+00 0.000000000000000000e+00 0.000000000000000000e+00 0.000000000000000000e+00 0.000000000000000000e+00 0.000000000000000000e+00 0.000000000000000000e+00 0.000000000000000000e+00 0.000000000000000000e+00 0.000000000000000000e+00 0.000000000000000000e+00 0.000000000000000000e+00 0.000000000000000000e+00 0.000000000000000000e+00 0.000000000000000000e+00
1.363681225856108448e+01 1.503593971151075692e+01 2.180729880015501365e+01 0.000000000000000000e+00 0.000000000000000000e+00 0.000000000000000000e+00 0.000000000000000000e+00 0.000000000000000000e+00 0.000000000000000000e+00 0.000000000000000000e+00 0.000000000000000000e+00 0.000000000000000000e+00 0.000000000000000000e+00 0.000000000000000000e+00 0.000000000000000000e+00 0.000000000000000000e+00 0.000000000000000000e+00 0.000000000000000000e+00 0.000000000000000000e+00 2.274433451129154093e+01
1.363681225856108448e+01 1.472648456644762760e+01 2.180729880015501365e+01 0.000000000000000000e+00 0.000000000000000000e+00 0.000000000000000000e+00 0.000000000000000000e+00 0.000000000000000000e+00 0.000000000000000000e+00 0.000000000000000000e+00 0.000000000000000000e+00 0.000000000000000000e+00 0.000000000000000000e+00 0.000000000000000000e+00 0.000000000000000000e+00 0.000000000000000000e+00 0.000000000000000000e+00 0.000000000000000000e+00 0.000000000000000000e+00 2.197348011732145778e+01
1.363681225856108448e+01 1.472648456644762760e+01 1.914330839257968009e+01 0.000000000000000000e+00 0.000000000000000000e+00 0.000000000000000000e+00 0.000000000000000000e+00 0.000000000000000000e+00 0.000000000000000000e+00 0.000000000000000000e+00 0.000000000000000000e+00 0.000000000000000000e+00 0.000000000000000000e+00 0.000000000000000000e+00 0.000000000000000000e+00 0.000000000000000000e+00 0.000000000000000000e+00 0.000000000000000000e+00 2.197348011732145778e+01 1.758869351964325745e+01
1.363681225856108448e+01 1.363681225856108448e+01 1.914330839257968009e+01 0.000000000000000000e+00 0.000000000000000000e+00 0.000000000000000000e+00 0.000000000000000000e+00 0.000000000000000000e+00 0.000000000000000000e+00 0.000000000000000000e+00 0.000000000000000000e+00 0.000000000000000000e+00 0.000000000000000000e+00 0.000000000000000000e+00 0.000000000000000000e+00 0.000000000000000000e+00 0.000000000000000000e+00 0.000000000000000000e+00 2.197348011732145778e+01 1.758869351964325745e+01
1.363681225856108448e+01 1.263120930571081857e+01 1.503593971151075692e+01 2.180729880015501365e+01 0.000000000000000000e+00 0.000000000000000000e+00 0.000000000000000000e+00 0.000000000000000000e+00 0.000000000000000000e+00 0.000000000000000000e+00 0.000000000000000000e+00 0.000000000000000000e+00 0.000000000000000000e+00 0.000000000000000000e+00 0.000000000000000000e+00 0.000000000000000000e+00 0.000000000000000000e+00 2.180729880015501365e+01 1.758869351964325745e+01 1.263120930571081857e+01
1.363681225856108448e+01 1.363681225856108448e+01 1.263120930571081857e+01 1.815024515202042110e+01 2.180729880015501365e+01 0.000000000000000000e+00 0.000000000000000000e+00 0.000000000000000000e+00 0.000000000000000000e+00 0.000000000000000000e+00 0.000000000000000000e+00 0.000000000000000000e+00 0.000000000000000000e+00 0.000000000000000000e+00 0.000000000000000000e+00 2.180729880015501365e+01 1.758869351964325745e+01 1.758869351964325745e+01 1.263120930571081857e+01 1.363681225856108448e+01
1.363681225856108448e+01 1.363681225856108448e+01 1.363681225856108448e+01 1.263120930571081857e+01 1.363681225856108448e+01 2.180729880015501365e+01 0.000000000000000000e+00 0.000000000000000000e+00 0.000000000000000000e+00 0.000000000000000000e+00 0.000000000000000000e+00 0.000000000000000000e+00 0.000000000000000000e+00 2.180729880015501365e+01 2.180729880015501365e+01 1.758869351964325745e+01 1.363681225856108448e+01 1.263120930571081857e+01 1.363681225856108448e+01 1.363681225856108448e+01
1.363681225856108448e+01 1.363681225856108448e+01 1.363681225856108448e+01 1.363681225856108448e+01 1.263120930571081857e+01 1.363681225856108448e+01 1.815024515202042110e+01 1.815024515202042110e+01 2.180729880015501365e+01 2.180729880015501365e+01 2.180729880015501365e+01 1.815024515202042110e+01 1.873440249320861994e+01 1.873440249320861994e+01 1.363681225856108448e+01 1.263120930571081857e+01 1.263120930571081857e+01 1.363681225856108448e+01 1.363681225856108448e+01 1.363681225856108448e+01
