1.086025409388881613e+01 1.086025409388881613e+01 1.086025409388881613e+01 1.086025409388881613e+01 1.147078995363500553e+01 1.147078995363500553e+01 2.103761804341606023e+01 3.334162876807516795e+01 4.201590476081225489e+01 5.725467365865660696e+01 7.283679542490487790e+01 8.587525946710633207e+01 8.882555568967572412e+01 9.635302401606689671e+01 1.012122986493753700e+02 1.061917331718615856e+02 1.153864325128025143e+02 9.574027468639023652e+01 7.616838353962739916e+01 4.185368550760254180e+01
1.086025409388881613e+01 1.086025409388881613e+01 1.086025409388881613e+01 1.086025409388881613e+01 1.086025409388881613e+01 1.898624532192540926e+01 3.122538675790785234e+01 4.530550033778269636e+01 6.181344965066297448e+01 7.575981923911486149e+01 8.882555568967572412e+01 8.630451783428087253e+01 8.049072613337135351e+01 8.559466602443458783e+01 9.764740920362447696e+01 1.113674589718777383e+02 1.199240398258747149e+02 1.080720085465406441e+02 7.761506723706115451e+01 5.008391477172821737e+01
1.086025409388881613e+01 1.086025409388881613e+01 1.086025409388881613e+01 1.086025409388881613e+01 1.387799283009122320e+01 2.090783292994696296e+01 3.546508023773436946e+01 5.660841760517372734e+01 7.827139248787365489e+01 8.828067765274859369e+01 8.630451783428087253e+01 7.508028722149870759e+01 6.827377506800323204e+01 6.502499540329849026e+01 7.992423938359198132e+01 1.012971964557401350e+02 1.158224090343783246e+02 1.043597880734814680e+02 7.761506723706115451e+01 4.844127864275660045e+01
1.086025409388881613e+01 1.086025409388881613e+01 1.086025409388881613e+01 1.086025409388881613e+01 1.387799283009122320e+01 2.090783292994696296e+01 3.763479976630730306e+01 5.886669717737012064e+01 7.287722175912884381e+01 7.887602757999994196e+01 6.879057891459382290e+01 5.691762766944562912e+01 4.659803228114409990e+01 5.640205172934702205e+01 7.225732157984663218e+01 8.950427893524502565e+01 1.109510011157192793e+02 1.008970087921846925e+02 7.007517740221742031e+01 4.622030737355205332e+01
1.086025409388881613e+01 1.086025409388881613e+01 1.086025409388881613e+01 1.086025409388881613e+01 1.086025409388881613e+01 2.349478139652563158e+01 3.388702605011141600e+01 5.104127187800575882e+01 5.688312356916659951e+01 5.216295948627143986e+01 5.027458216561596061e+01 3.605078999462622846e+01 3.996796739127028530e+01 4.788343333675526026e+01 7.721115383985404890e+01 9.643927369327735732e+01 1.058849229860811789e+02 8.848947751150174668e+01 6.624619063789253914e+01 3.829441719014133838e+01
1.086025409388881613e+01 1.086025409388881613e+01 1.086025409388881613e+01 1.086025409388881613e+01 1.086025409388881613e+01 1.086025409388881613e+01 2.630452790315353795e+01 3.187637608557330182e+01 4.080342231552256749e+01 3.854097722142306992e+01 3.147760607835941116e+01 3.339238339655292265e+01 4.017520831348088706e+01 5.829088487273489960e+01 8.197363269594195856e+01 1.063564951515494386e+02 1.035128937191947784e+02 8.054866492259111510e+01 5.580650486288243428e+01 3.166021496948101444e+01
1.086025409388881613e+01 1.086025409388881613e+01 1.086025409388881613e+01 1.086025409388881613e+01 1.086025409388881613e+01 1.086025409388881613e+01 1.086025409388881613e+01 2.199092339112701566e+01 2.482414283412323641e+01 3.235851413714464542e+01 3.134075939326456606e+01 4.201590476081225489e+01 5.802503156858293210e+01 7.750798706474442668e+01 9.474746312504508694e+01 1.058849229860811789e+02 9.458918395359897602e+01 6.782355274164727632e+01 4.663605049050162421e+01 2.490037150257543530e+01
1.086025409388881613e+01 1.086025409388881613e+01 1.086025409388881613e+01 1.147078995363500553e+01 1.147078995363500553e+01 1.147078995363500553e+01 1.635032104309703982e+01 1.898624532192540926e+01 2.450978169909940974e+01 2.864755114923606527e+01 4.269017772574038361e+01 6.181344965066297448e+01 8.473706218398866952e+01 9.710724812454957089e+01 1.041045544812906343e+02 9.658433040011443893e+01 7.296510339877983142e+01 5.316887009454573132e+01 3.300496890800970817e+01 1.398769667877241574e+01
1.086025409388881613e+01 1.147078995363500553e+01 1.147078995363500553e+01 1.837134595259106362e+01 2.362534741067906197e+01 2.642750068688791742e+01 2.765815299346963485e+01 2.642750068688791742e+01 3.205041445803752964e+01 4.201590476081225489e+01 6.406487133881421414e+01 7.921109360082573403e+01 9.776237126100710384e+01 1.071966218848032071e+02 9.888486620411501349e+01 8.276603759148228789e+01 5.801348934850261685e+01 3.558234291961488793e+01 2.490037150257543530e+01 1.398769667877241574e+01
1.147078995363500553e+01 1.147078995363500553e+01 2.007664841524082888e+01 2.841784789956021129e+01 3.793701166723663931e+01 4.275124909452586763e+01 5.383762621459602826e+01 5.147059158491578756e+01 5.482696334956748530e+01 6.579763334965480226e+01 9.132353764593966616e+01 9.710724812454957089e+01 1.127014886231095119e+02 1.049247337172851502e+02 8.461010262780149560e+01 5.887490905342765046e+01 3.917779763357049205e+01 2.553674974168561107e+01 1.398769667877241574e+01 1.265959962035130637e+01
1.513667193724102411e+01 2.309587474134727003e+01 3.452608949830435847e+01 4.851721019693122372e+01 5.802503156858293210e+01 7.451852821981542263e+01 7.895148659788326029e+01 8.889699847894233642e+01 9.124146680963146139e+01 9.710724812454957089e+01 1.029133232995054783e+02 1.131229098204222652e+02 1.191309458011854616e+02 1.008970087921846925e+02 7.580965488031009158e+01 4.937008176674751780e+01 2.956964572955964954e+01 1.997581127391855560e+01 1.265959962035130637e+01 1.086025409388881613e+01
2.309587474134727003e+01 3.843342569933732733e+01 5.802503156858293210e+01 7.451852821981542263e+01 9.132353764593966616e+01 1.029133232995054783e+02 1.048493699533243415e+02 1.113891188404837180e+02 1.153864325128025143e+02 1.153864325128025143e+02 1.242233245531780454e+02 1.242233245531780454e+02 1.210708524376180577e+02 9.925907172791617938e+01 7.616838353962739916e+01 4.766987403012847579e+01 2.873990598304915878e+01 1.398769667877241574e+01 1.086025409388881613e+01 1.086025409388881613e+01
3.684485814785733027e+01 5.829088487273489960e+01 7.750798706474442668e+01 9.710724812454957089e+01 1.096534067943033222e+02 1.242233245531780454e+02 1.242233245531780454e+02 1.313037588173091876e+02 1.313037588173091876e+02 1.267372502689203628e+02 1.267372502689203628e+02 1.267372502689203628e+02 1.286838390691822269e+02 1.113891188404837180e+02 7.642422032014707156e+01 5.475482700641076406e+01 2.993339851228013870e+01 1.398769667877241574e+01 1.147078995363500553e+01 1.086025409388881613e+01
5.079764962848646093e+01 7.750798706474442668e+01 1.005750975064129875e+02 1.207001115812032452e+02 1.313037588173091876e+02 1.383940578537278725e+02 1.383940578537278725e+02 1.383940578537278725e+02 1.248435921841416274e+02 1.205283074343507792e+02 1.121184709846179288e+02 1.233949847157437034e+02 1.233949847157437034e+02 1.199240398258747149e+02 9.563974831064969351e+01 6.117098969109301265e+01 4.021993488090814139e+01 2.202509809513988870e+01 1.147078995363500553e+01 1.086025409388881613e+01
7.061408389157361398e+01 1.005750975064129875e+02 1.131229098204222652e+02 1.383940578537278725e+02 1.383940578537278725e+02 1.383940578537278725e+02 1.383940578537278725e+02 1.160952429364543690e+02 1.079816381130909662e+02 9.658433040011443893e+01 8.752079703305896885e+01 9.978644170984468076e+01 1.113674589718777383e+02 1.199240398258747149e+02 9.667825062404806147e+01 7.616838353962739916e+01 5.475482700641076406e+01 2.993339851228013870e+01 1.398769667877241574e+01 1.147078995363500553e+01
8.927614617602915814e+01 1.118760518140094860e+02 1.313037588173091876e+02 1.383940578537278725e+02 1.383940578537278725e+02 1.160952429364543690e+02 1.079816381130909662e+02 9.658433040011443893e+01 8.322602232613294859e+01 6.879057891459382290e+01 5.691762766944562912e+01 6.502499540329849026e+01 8.570441209213987577e+01 9.978644170984468076e+01 1.092479197000645712e+02 9.029288949445700041e+01 6.117098969109301265e+01 3.978625883174039757e+01 2.202509809513988870e+01 1.147078995363500553e+01
9.091407319281228183e+01 1.123024303073425898e+02 1.248435921841416274e+02 1.383940578537278725e+02 1.160952429364543690e+02 1.079816381130909662e+02 9.325902901775285159e+01 7.346421039204300030e+01 5.691762766944562912e+01 4.088479901846596931e+01 3.502344597532530202e+01 4.280925302017612921e+01 6.155467068425413402e+01 8.570441209213987577e+01 9.304352647469031012e+01 9.667825062404806147e+01 6.612040471400814567e+01 4.185368550760254180e+01 2.472794785231747383e+01 1.398769667877241574e+01
8.570441209213987577e+01 1.063904798206014277e+02 1.121184709846179288e+02 1.062729331192890783e+02 1.047738185740964951e+02 8.322602232613294859e+01 6.606404313207930556e+01 4.488947653655188219e+01 3.605078999462622846e+01 2.376139158756334879e+01 2.199092339112701566e+01 2.878493346496655647e+01 4.881672705296045933e+01 7.068830606338596567e+01 8.559466602443458783e+01 8.295820827485614757e+01 6.612040471400814567e+01 4.380370781448870332e+01 2.472794785231747383e+01 1.265959962035130637e+01
6.502499540329849026e+01 7.832164830691115753e+01 8.226881104641580578e+01 8.322602232613294859e+01 6.879057891459382290e+01 5.027458216561596061e+01 3.964832289000969467e+01 3.007228665707719273e+01 2.376139158756334879e+01 1.265959962035130637e+01 1.354387468837249386e+01 2.349478139652563158e+01 3.187637608557330182e+01 4.674448169514695905e+01 5.688312356916659951e+01 6.827377506800323204e+01 5.316887009454573132e+01 3.891414668209541361e+01 2.433328676543170133e+01 1.265959962035130637e+01
4.674448169514695905e+01 5.142465888515245354e+01 5.135839034069367415e+01 4.400915769982604075e+01 4.088479901846596931e+01 2.892115245344225016e+01 2.521641010348762535e+01 1.779840041986890142e+01 1.265959962035130637e+01 1.086025409388881613e+01 1.086025409388881613e+01 1.086025409388881613e+01 2.349478139652563158e+01 3.187637608557330182e+01 3.818605468039557138e+01 4.400915769982604075e+01 4.088479901846596931e+01 2.553674974168561107e+01 1.398769667877241574e+01 1.265959962035130637e+01
