1.106300092907922661e+01 1.106300092907922661e+01 1.106300092907922661e+01 1.106300092907922661e+01 1.898290830843226118e+01 2.679175599638287864e+01 4.258016169727917344e+01 6.269370575654928501e+01 7.502348307834790830e+01 8.616605136724128045e+01 8.917118452136480755e+01 9.070151975166196223e+01 8.735599339930378449e+01 7.056676616106132371e+01 6.056110159603375820e+01 3.893128589242299142e+01 2.341591879747660698e+01 1.106300092907922661e+01 1.106300092907922661e+01 1.106300092907922661e+01
1.106300092907922661e+01 1.106300092907922661e+01 1.106300092907922661e+01 1.106300092907922661e+01 2.089100076946766649e+01 2.916467772804626790e+01 4.904502340449872122e+01 6.232996324686784106e+01 7.287722175912884381e+01 8.528264359202880485e+01 8.528264359202880485e+01 9.768699831221876195e+01 9.076925745594560624e+01 9.338880003901110172e+01 6.759611020901610345e+01 4.354618718771538255e+01 2.993339851228013870e+01 2.165096377748534451e+01 1.106300092907922661e+01 1.106300092907922661e+01
1.106300092907922661e+01 1.106300092907922661e+01 1.106300092907922661e+01 1.106300092907922661e+01 2.085704346369211137e+01 2.749195228649502454e+01 4.059568938348139966e+01 5.688312356916659951e+01 6.046771979685294696e+01 6.772810066084508662e+01 6.553764036369207702e+01 8.033475487341382859e+01 8.559466602443458783e+01 9.076925745594560624e+01 8.168445796081245192e+01 6.117098969109301265e+01 3.516409427877179894e+01 2.341591879747660698e+01 1.106300092907922661e+01 1.106300092907922661e+01
1.106300092907922661e+01 1.106300092907922661e+01 1.106300092907922661e+01 1.106300092907922661e+01 1.106300092907922661e+01 2.493715474313448865e+01 3.379701954420713861e+01 3.878933190873910064e+01 4.400915769982604075e+01 3.724953654301575057e+01 4.560082086381255095e+01 5.640053915948501384e+01 8.033475487341382859e+01 9.306438872929622619e+01 8.703253046435251861e+01 6.727140607513875636e+01 4.448541267552365497e+01 2.165096377748534451e+01 1.265120113150370607e+01 1.106300092907922661e+01
1.106300092907922661e+01 1.106300092907922661e+01 1.106300092907922661e+01 1.106300092907922661e+01 1.106300092907922661e+01 1.460665488214961449e+01 2.290552436149128823e+01 2.610125712061747905e+01 2.610125712061747905e+01 2.482414283412323641e+01 2.970292655654878189e+01 4.265311764792632232e+01 6.472285075899918638e+01 8.714797636787280055e+01 8.846518911227670401e+01 7.494795230144931963e+01 4.380370781448870332e+01 2.472794785231747383e+01 1.265120113150370607e+01 1.106300092907922661e+01
1.106300092907922661e+01 1.106300092907922661e+01 1.106300092907922661e+01 1.106300092907922661e+01 1.106300092907922661e+01 1.106300092907922661e+01 1.460665488214961449e+01 1.837856612832709757e+01 2.068364307042332229e+01 2.444406279689965089e+01 3.479209495554098908e+01 5.211856397322731027e+01 6.993062251844790467e+01 8.639943219058943669e+01 8.846518911227670401e+01 6.467206645877702442e+01 4.331118878905085268e+01 2.472794785231747383e+01 1.265120113150370607e+01 1.106300092907922661e+01
1.106300092907922661e+01 1.106300092907922661e+01 1.106300092907922661e+01 1.106300092907922661e+01 1.106300092907922661e+01 1.106300092907922661e+01 1.298212774652287393e+01 1.898290830843226118e+01 2.811842430184293562e+01 3.642983904764317771e+01 5.376732621091984043e+01 6.558247461188982186e+01 8.512661204396221137e+01 8.833147042188174680e+01 8.028667040534335797e+01 5.891354129768262737e+01 3.510537993490145681e+01 2.165096377748534451e+01 1.265120113150370607e+01 1.106300092907922661e+01
1.106300092907922661e+01 1.106300092907922661e+01 1.106300092907922661e+01 1.106300092907922661e+01 1.106300092907922661e+01 1.106300092907922661e+01 1.298212774652287393e+01 2.237683476398031246e+01 3.682371981202565792e+01 5.724941330558358032e+01 7.498578376159275649e+01 9.132353764593966616e+01 9.713661142785507252e+01 9.085625515300428390e+01 7.538575224983350154e+01 5.297500169942210135e+01 2.961223956237100552e+01 1.779960086878999093e+01 1.106300092907922661e+01 1.106300092907922661e+01
1.106300092907922661e+01 1.106300092907922661e+01 1.106300092907922661e+01 1.106300092907922661e+01 1.106300092907922661e+01 1.106300092907922661e+01 1.298212774652287393e+01 2.531372258099227324e+01 4.258016169727917344e+01 6.846609799246083128e+01 9.321057797521244481e+01 1.070607418070674299e+02 1.102096684171561378e+02 9.836736531426137731e+01 7.580276893577678266e+01 4.648801469045948664e+01 2.472794785231747383e+01 1.265120113150370607e+01 1.106300092907922661e+01 1.106300092907922661e+01
1.106300092907922661e+01 1.106300092907922661e+01 1.106300092907922661e+01 1.106300092907922661e+01 1.106300092907922661e+01 1.106300092907922661e+01 1.298212774652287393e+01 2.749195228649502454e+01 3.818544431370498415e+01 6.168811268288132510e+01 8.767272927748243205e+01 1.110132146034566460e+02 1.106942551526976928e+02 9.609857398526509087e+01 7.440326696388322603e+01 4.388954306298605701e+01 2.533735722141451063e+01 1.265120113150370607e+01 1.106300092907922661e+01 1.106300092907922661e+01
1.106300092907922661e+01 1.106300092907922661e+01 1.106300092907922661e+01 1.106300092907922661e+01 1.106300092907922661e+01 1.106300092907922661e+01 1.460665488214961449e+01 2.493715474313448865e+01 3.379701954420713861e+01 5.609011982076476244e+01 7.533679385468528267e+01 9.765652219451320093e+01 1.077001266923646341e+02 9.874523712090589811e+01 7.421072814413324181e+01 4.937488817870156055e+01 2.707011226733420983e+01 1.265120113150370607e+01 1.106300092907922661e+01 1.106300092907922661e+01
1.106300092907922661e+01 1.106300092907922661e+01 1.106300092907922661e+01 1.106300092907922661e+01 1.106300092907922661e+01 1.298212774652287393e+01 1.930331983906824789e+01 2.109693569324945273e+01 2.878480242703291836e+01 4.059568938348139966e+01 5.902128706191970764e+01 8.033475487341382859e+01 9.765652219451320093e+01 1.012510241288748887e+02 7.949837561372079620e+01 5.737569223120820538e+01 2.873990598304915878e+01 1.265120113150370607e+01 1.106300092907922661e+01 1.106300092907922661e+01
1.106300092907922661e+01 1.106300092907922661e+01 1.106300092907922661e+01 1.106300092907922661e+01 1.513667193724102411e+01 2.230506501927262519e+01 2.642750068688791742e+01 2.996734010402867909e+01 3.107087077665966035e+01 3.747396513350329172e+01 4.847363025793781333e+01 6.472285075899918638e+01 8.514804768908054200e+01 9.814723396219251583e+01 8.979230875654462807e+01 5.737569223120820538e+01 3.592703397906297624e+01 2.169233731671396370e+01 1.106300092907922661e+01 1.106300092907922661e+01
1.106300092907922661e+01 1.106300092907922661e+01 1.106300092907922661e+01 1.513667193724102411e+01 2.374398581949679254e+01 3.642983904764317771e+01 4.415113662703367226e+01 5.184709952833273405e+01 4.994664874632070450e+01 4.237172772466104931e+01 5.053592204178725922e+01 5.871445622556637289e+01 8.211418331749418087e+01 9.306438872929622619e+01 8.979230875654462807e+01 6.612040471400814567e+01 3.594469381786219486e+01 2.165096377748534451e+01 1.106300092907922661e+01 1.106300092907922661e+01
1.106300092907922661e+01 1.106300092907922661e+01 1.513667193724102411e+01 2.427424062440862329e+01 3.897770850809068577e+01 5.724941330558358032e+01 7.242766092784754051e+01 7.968893809228836744e+01 7.198282591695618748e+01 6.056110159603375820e+01 5.840906441484055023e+01 7.279724150828415929e+01 8.188195720090044460e+01 9.125470046086223874e+01 8.273113992118130966e+01 5.906828601394292377e+01 3.772592545068774683e+01 2.165096377748534451e+01 1.265120113150370607e+01 1.106300092907922661e+01
1.106300092907922661e+01 1.106300092907922661e+01 1.990596944687126424e+01 3.685834295612110623e+01 6.181344965066297448e+01 8.101033882729426239e+01 9.586418476512459108e+01 9.691760657841794568e+01 9.439061252242548505e+01 8.375074020428093036e+01 7.798773371299057544e+01 8.150450003186716685e+01 8.779070006339884458e+01 8.649915044438404266e+01 7.183505170852018296e+01 5.236774628605353143e+01 3.081551231548089831e+01 2.165096377748534451e+01 1.106300092907922661e+01 1.106300092907922661e+01
1.106300092907922661e+01 1.298212774652287393e+01 2.531372258099227324e+01 4.841389169284386185e+01 6.917283507069113568e+01 1.005721958207843301e+02 1.155656033314345024e+02 1.184432566230030801e+02 1.150050450093882120e+02 1.043082277340089234e+02 9.181800789010860342e+01 9.099545579817521457e+01 8.508430011727419640e+01 8.028667040534335797e+01 5.887490905342765046e+01 4.113143548246773662e+01 2.368249920005213127e+01 1.265120113150370607e+01 1.106300092907922661e+01 1.106300092907922661e+01
1.106300092907922661e+01 1.513667193724102411e+01 2.849952933223782381e+01 4.914751956897092100e+01 7.533679385468528267e+01 9.361386795063755528e+01 1.063904798206014277e+02 1.121184709846179288e+02 1.093766372396100195e+02 9.856492053074865112e+01 9.856492053074865112e+01 8.920697484068591621e+01 7.377314291703029880e+01 6.314028678373244929e+01 4.683490665424223209e+01 3.120315890219822919e+01 2.377463434861781977e+01 1.265120113150370607e+01 1.106300092907922661e+01 1.106300092907922661e+01
1.106300092907922661e+01 1.298212774652287393e+01 2.749195228649502454e+01 4.059568938348139966e+01 5.902128706191970764e+01 7.661949822627201456e+01 8.644843669818141052e+01 8.174764197364223151e+01 8.652408755966405352e+01 8.326412216751359097e+01 7.887602757999994196e+01 6.606404313207930556e+01 5.691762766944562912e+01 4.010867624457574721e+01 2.982301533422673856e+01 2.351640075703397770e+01 1.265120113150370607e+01 1.106300092907922661e+01 1.106300092907922661e+01 1.106300092907922661e+01
1.106300092907922661e+01 1.106300092907922661e+01 2.085704346369211137e+01 3.379701954420713861e+01 4.080355276098583772e+01 5.107745186622668143e+01 5.847446684007483242e+01 5.847446684007483242e+01 5.847446684007483242e+01 5.113696424142695918e+01 4.934547459608204178e+01 4.400915769982604075e+01 3.675932002631432738e+01 2.514519434047412361e+01 1.779960086878999093e+01 1.265120113150370607e+01 1.106300092907922661e+01 1.106300092907922661e+01 1.106300092907922661e+01 1.106300092907922661e+01
