1.135182151222470992e+01 1.135182151222470992e+01 1.135182151222470992e+01 1.135182151222470992e+01 1.135182151222470992e+01 1.135182151222470992e+01 1.898624532192540926e+01 2.309587474134727003e+01 3.205041445803752964e+01 4.008360321266010118e+01 4.008360321266010118e+01 4.237172772466104931e+01 3.261402268888410561e+01 2.634569192791764536e+01 2.202509809513988870e+01 1.135182151222470992e+01 1.135182151222470992e+01 1.135182151222470992e+01 1.135182151222470992e+01 1.135182151222470992e+01
1.135182151222470992e+01 1.135182151222470992e+01 1.135182151222470992e+01 1.135182151222470992e+01 1.135182151222470992e+01 1.898624532192540926e+01 2.864755114923606527e+01 3.650988600537813511e+01 4.574225941216437974e+01 5.840906441484055023e+01 6.579763334965480226e+01 5.426033172816278238e+01 5.426033172816278238e+01 4.097780613246419534e+01 3.391821377368962231e+01 2.435978664769612578e+01 1.232933074517587357e+01 1.135182151222470992e+01 1.135182151222470992e+01 1.135182151222470992e+01
1.135182151222470992e+01 1.135182151222470992e+01 1.135182151222470992e+01 1.135182151222470992e+01 1.513667193724102411e+01 2.354237111229262425e+01 3.682371981202565792e+01 5.416723716908238373e+01 6.489454775109602735e+01 7.512165202444981560e+01 7.348030181061091071e+01 7.864775299967952549e+01 7.474645782807657213e+01 5.855870590381934448e+01 4.929010723282313222e+01 3.391821377368962231e+01 2.202509809513988870e+01 1.266182140766219177e+01 1.135182151222470992e+01 1.135182151222470992e+01
1.135182151222470992e+01 1.135182151222470992e+01 1.135182151222470992e+01 1.135182151222470992e+01 1.988600114128365703e+01 3.158377771282566115e+01 5.207263849647343079e+01 6.562895074333847845e+01 7.348030181061091071e+01 7.703802447213989524e+01 7.022014716078018637e+01 7.022014716078018637e+01 7.875471013477017834e+01 8.044646939677400610e+01 7.056676616106132371e+01 4.189624614473882502e+01 2.772480485986402599e+01 2.036636403240849802e+01 1.135182151222470992e+01 1.135182151222470992e+01
1.135182151222470992e+01 1.135182151222470992e+01 1.135182151222470992e+01 1.296879374731471302e+01 2.090783292994696296e+01 3.952676966911750611e+01 5.660841760517372734e+01 6.982600419377698131e+01 7.630831617099994446e+01 6.280981206811215145e+01 5.639756080913119973e+01 6.155467068425413402e+01 7.381724080597643933e+01 8.700890255376515370e+01 7.075317548249138611e+01 5.329084466681283772e+01 3.286443394231579873e+01 1.983917948555748012e+01 1.135182151222470992e+01 1.135182151222470992e+01
1.135182151222470992e+01 1.135182151222470992e+01 1.135182151222470992e+01 1.296879374731471302e+01 2.398491456375341002e+01 3.952676966911750611e+01 6.246210043024009906e+01 7.216933563155708953e+01 6.676295124707827711e+01 5.807081860206532298e+01 5.587799365962267473e+01 5.809288440795142350e+01 7.955770609607436938e+01 7.630831617099994446e+01 6.777078756221685296e+01 5.178039814389978091e+01 2.987578492432903943e+01 1.983917948555748012e+01 1.135182151222470992e+01 1.135182151222470992e+01
1.135182151222470992e+01 1.135182151222470992e+01 1.135182151222470992e+01 1.296879374731471302e+01 2.349478139652563158e+01 3.952676966911750611e+01 5.809288440795142350e+01 7.216933563155708953e+01 7.075317548249138611e+01 5.443488790548891387e+01 5.840906441484055023e+01 6.269471065245076602e+01 7.381724080597643933e+01 7.630831617099994446e+01 6.467955276440835632e+01 4.277353276790253744e+01 2.655180726855720152e+01 1.266182140766219177e+01 1.135182151222470992e+01 1.135182151222470992e+01
1.135182151222470992e+01 1.135182151222470992e+01 1.135182151222470992e+01 1.135182151222470992e+01 2.349478139652563158e+01 3.388702605011141600e+01 4.881672705296045933e+01 6.540570733552866045e+01 7.439720774486600874e+01 7.056676616106132371e+01 7.219886583109624212e+01 6.982600419377698131e+01 7.630831617099994446e+01 6.467955276440835632e+01 5.054984403193601139e+01 3.384902297313315955e+01 2.295287770201630195e+01 1.266182140766219177e+01 1.135182151222470992e+01 1.135182151222470992e+01
1.135182151222470992e+01 1.135182151222470992e+01 1.135182151222470992e+01 1.135182151222470992e+01 1.837856612832709757e+01 2.749142178355513977e+01 4.881672705296045933e+01 6.246210043024009906e+01 7.955770609607436938e+01 8.935920215585173310e+01 8.865565298908497027e+01 7.598099393146308955e+01 6.524940648592205150e+01 5.420577560772971282e+01 3.676695181935247803e+01 2.490037150257543530e+01 1.266182140766219177e+01 1.135182151222470992e+01 1.135182151222470992e+01 1.135182151222470992e+01
1.135182151222470992e+01 1.135182151222470992e+01 1.135182151222470992e+01 1.135182151222470992e+01 1.135182151222470992e+01 2.349478139652563158e+01 3.388702605011141600e+01 5.579125899993440640e+01 7.955770609607436938e+01 9.246757662395572197e+01 9.315539811725049901e+01 8.521802689780558637e+01 6.676295124707827711e+01 4.622030737355205332e+01 3.166021496948101444e+01 2.295287770201630195e+01 1.266182140766219177e+01 1.135182151222470992e+01 1.135182151222470992e+01 1.135182151222470992e+01
1.135182151222470992e+01 1.135182151222470992e+01 1.135182151222470992e+01 1.135182151222470992e+01 1.135182151222470992e+01 1.837856612832709757e+01 2.749142178355513977e+01 4.914956161446551164e+01 7.360005091671919786e+01 9.246757662395572197e+01 9.875640738573000021e+01 8.575386017525627835e+01 6.495691828137695722e+01 4.622030737355205332e+01 2.367749749401147241e+01 1.266182140766219177e+01 1.135182151222470992e+01 1.135182151222470992e+01 1.135182151222470992e+01 1.135182151222470992e+01
1.135182151222470992e+01 1.135182151222470992e+01 1.135182151222470992e+01 1.135182151222470992e+01 1.135182151222470992e+01 1.513667193724102411e+01 2.721266295227543353e+01 4.914956161446551164e+01 7.225732157984663218e+01 9.246757662395572197e+01 9.856492053074865112e+01 8.848947751150174668e+01 6.618329767595034241e+01 4.185368550760254180e+01 2.873990598304915878e+01 1.266182140766219177e+01 1.135182151222470992e+01 1.135182151222470992e+01 1.135182151222470992e+01 1.135182151222470992e+01
1.135182151222470992e+01 1.135182151222470992e+01 1.135182151222470992e+01 1.135182151222470992e+01 1.135182151222470992e+01 1.898624532192540926e+01 2.853193647683530543e+01 4.914956161446551164e+01 7.225732157984663218e+01 8.745025411626610889e+01 9.238562003017075597e+01 8.295820827485614757e+01 7.075317548249138611e+01 4.835570686753261072e+01 2.772480485986402599e+01 2.202509809513988870e+01 1.135182151222470992e+01 1.135182151222470992e+01 1.135182151222470992e+01 1.135182151222470992e+01
1.135182151222470992e+01 1.135182151222470992e+01 1.135182151222470992e+01 1.135182151222470992e+01 1.135182151222470992e+01 1.988600114128365703e+01 3.279836236708239738e+01 4.904502340449872122e+01 6.460339590466168147e+01 7.979088602701146726e+01 7.649472181174928664e+01 7.649472181174928664e+01 7.075317548249138611e+01 5.152673589592922099e+01 3.868275801220389098e+01 2.202509809513988870e+01 1.266182140766219177e+01 1.135182151222470992e+01 1.135182151222470992e+01 1.135182151222470992e+01
1.135182151222470992e+01 1.135182151222470992e+01 1.135182151222470992e+01 1.135182151222470992e+01 1.296879374731471302e+01 2.090783292994696296e+01 3.910936811875919261e+01 4.904502340449872122e+01 6.432957743292557495e+01 5.957020917402427074e+01 6.017403717552162590e+01 6.540570733552866045e+01 6.432957743292557495e+01 5.152673589592922099e+01 4.185368550760254180e+01 2.873990598304915878e+01 1.266182140766219177e+01 1.135182151222470992e+01 1.135182151222470992e+01 1.135182151222470992e+01
1.135182151222470992e+01 1.135182151222470992e+01 1.135182151222470992e+01 1.135182151222470992e+01 1.296879374731471302e+01 2.533499713933312592e+01 3.910936811875919261e+01 5.273821512029796565e+01 6.061901868480526900e+01 5.957020917402427074e+01 5.782476117857964226e+01 5.273821512029796565e+01 6.441521440035252510e+01 6.524940648592205150e+01 4.835570686753261072e+01 2.930096516431831333e+01 1.266182140766219177e+01 1.135182151222470992e+01 1.135182151222470992e+01 1.135182151222470992e+01
1.135182151222470992e+01 1.135182151222470992e+01 1.135182151222470992e+01 1.135182151222470992e+01 1.898624532192540926e+01 2.533499713933312592e+01 4.302843570940180484e+01 5.645774041201119786e+01 5.757532609376556110e+01 5.152673589592922099e+01 5.587799365962267473e+01 5.512052336228663307e+01 6.432957743292557495e+01 6.121406016698389863e+01 4.622030737355205332e+01 2.655180726855720152e+01 1.266182140766219177e+01 1.135182151222470992e+01 1.135182151222470992e+01 1.135182151222470992e+01
1.135182151222470992e+01 1.135182151222470992e+01 1.135182151222470992e+01 1.135182151222470992e+01 1.898624532192540926e+01 2.853193647683530543e+01 4.302843570940180484e+01 6.194360900324985408e+01 6.489454775109602735e+01 6.160171488889440639e+01 5.840906441484055023e+01 5.645774041201119786e+01 6.432957743292557495e+01 5.372113904943980600e+01 3.883101030727689817e+01 2.367749749401147241e+01 1.266182140766219177e+01 1.135182151222470992e+01 1.135182151222470992e+01 1.135182151222470992e+01
1.135182151222470992e+01 1.135182151222470992e+01 1.135182151222470992e+01 1.135182151222470992e+01 1.898624532192540926e+01 2.853193647683530543e+01 4.904502340449872122e+01 6.441521440035252510e+01 7.875471013477017834e+01 7.474645782807657213e+01 6.634739123969629304e+01 7.348030181061091071e+01 5.957020917402427074e+01 5.054984403193601139e+01 3.384902297313315955e+01 2.295287770201630195e+01 1.266182140766219177e+01 1.135182151222470992e+01 1.135182151222470992e+01 1.135182151222470992e+01
1.135182151222470992e+01 1.135182151222470992e+01 1.135182151222470992e+01 1.135182151222470992e+01 1.898624532192540926e+01 2.749142178355513977e+01 4.046336383232158340e+01 6.252808554079436476e+01 7.565950774337534313e+01 7.565950774337534313e+01 7.630831617099994446e+01 5.957020917402427074e+01 5.420577560772971282e+01 4.113552921372583882e+01 2.490037150257543530e+01 1.266182140766219177e+01 1.266182140766219177e+01 1.135182151222470992e+01 1.135182151222470992e+01 1.135182151222470992e+01
