1.276937937111805610e+01 1.276937937111805610e+01 1.276937937111805610e+01 1.276937937111805610e+01 1.781634386159733197e+01 2.024262848225557221e+01 2.226924051535441151e+01 3.551114776451512967e+01 3.551114776451512967e+01 3.551114776451512967e+01 2.429634394861078661e+01 2.274433451129154093e+01 1.781634386159733197e+01 1.781634386159733197e+01 1.229118975302313999e+01 1.276937937111805610e+01 1.276937937111805610e+01 1.276937937111805610e+01 1.276937937111805610e+01 1.276937937111805610e+01
1.276937937111805610e+01 1.276937937111805610e+01 1.276937937111805610e+01 1.346185382475593961e+01 2.107041946530724275e+01 3.551114776451512967e+01 3.398233313098471342e+01 5.579771610975916474e+01 6.536620077422095676e+01 5.873506690431837285e+01 5.579771610975916474e+01 3.398233313098471342e+01 3.852946342759779697e+01 2.074032182779928490e+01 2.274433451129154093e+01 1.425081808425233909e+01 1.307479400354361765e+01 1.276937937111805610e+01 1.276937937111805610e+01 1.276937937111805610e+01
1.276937937111805610e+01 1.276937937111805610e+01 1.276937937111805610e+01 1.624541138711696675e+01 2.571931366295831367e+01 4.544930672814309958e+01 6.536620077422095676e+01 8.473706218398866952e+01 9.455339789055852862e+01 9.455339789055852862e+01 8.473706218398866952e+01 7.722304358575991046e+01 6.536620077422095676e+01 5.917515701836581599e+01 3.503192722168834194e+01 2.429634394861078661e+01 2.429634394861078661e+01 1.307479400354361765e+01 1.276937937111805610e+01 1.276937937111805610e+01
1.276937937111805610e+01 1.276937937111805610e+01 1.276937937111805610e+01 1.624541138711696675e+01 2.844415493163317876e+01 5.579771610975916474e+01 8.473706218398866952e+01 1.024902229814814092e+02 1.149394012836173715e+02 1.149394012836173715e+02 1.156011706255718678e+02 1.156011706255718678e+02 9.890538566223885653e+01 9.890538566223885653e+01 6.536620077422095676e+01 4.388741573118951322e+01 2.429634394861078661e+01 1.425081808425233909e+01 1.307479400354361765e+01 1.276937937111805610e+01
1.276937937111805610e+01 1.276937937111805610e+01 1.276937937111805610e+01 1.624541138711696675e+01 2.723693325506961571e+01 5.579771610975916474e+01 9.061351821465166267e+01 1.114412563448850904e+02 1.271239585928440192e+02 1.271239585928440192e+02 1.310470195447400670e+02 1.310470195447400670e+02 1.156011706255718678e+02 1.156011706255718678e+02 9.351019444423367588e+01 6.536620077422095676e+01 3.503192722168834194e+01 2.274433451129154093e+01 1.307479400354361765e+01 1.276937937111805610e+01
1.276937937111805610e+01 1.276937937111805610e+01 1.276937937111805610e+01 1.624541138711696675e+01 2.938419539932495184e+01 4.544930672814309958e+01 6.784284249974980696e+01 9.061351821465166267e+01 1.076187731729475416e+02 1.166902573099544043e+02 1.200471396976966503e+02 1.271239585928440192e+02 1.310470195447400670e+02 1.187199498112793492e+02 1.048833985899646848e+02 7.722304358575991046e+01 5.280497634287794995e+01 2.429634394861078661e+01 1.425081808425233909e+01 1.276937937111805610e+01
1.276937937111805610e+01 1.276937937111805610e+01 1.276937937111805610e+01 1.488359180660961911e+01 1.624541138711696675e+01 2.979192026876084753e+01 4.897855249540706524e+01 6.784284249974980696e+01 8.366689725956619839e+01 8.366689725956619839e+01 9.061351821465166267e+01 1.209469427973171349e+02 1.271239585928440192e+02 1.310470195447400670e+02 1.156011706255718678e+02 9.351019444423367588e+01 6.536620077422095676e+01 3.503192722168834194e+01 2.200210093066193906e+01 1.276937937111805610e+01
1.276937937111805610e+01 1.276937937111805610e+01 1.276937937111805610e+01 1.307479400354361765e+01 1.624541138711696675e+01 1.873159541693955887e+01 2.979192026876084753e+01 4.388741573118951322e+01 4.897855249540706524e+01 5.280497634287794995e+01 6.784284249974980696e+01 9.061351821465166267e+01 1.209469427973171349e+02 1.271239585928440192e+02 1.187199498112793492e+02 9.351019444423367588e+01 6.486431080355229994e+01 3.503192722168834194e+01 2.200210093066193906e+01 1.276937937111805610e+01
1.276937937111805610e+01 1.276937937111805610e+01 1.276937937111805610e+01 1.276937937111805610e+01 1.307479400354361765e+01 1.373470440770275935e+01 1.334637882523516161e+01 2.173153212747888219e+01 2.500523312913645668e+01 2.979192026876084753e+01 5.579771610975916474e+01 8.473706218398866952e+01 1.059842044656998041e+02 1.271239585928440192e+02 1.187199498112793492e+02 9.213599301706204869e+01 6.536620077422095676e+01 3.503192722168834194e+01 2.200210093066193906e+01 1.276937937111805610e+01
1.276937937111805610e+01 1.276937937111805610e+01 1.276937937111805610e+01 1.276937937111805610e+01 1.276937937111805610e+01 1.307479400354361765e+01 1.307479400354361765e+01 1.373470440770275935e+01 1.624541138711696675e+01 2.938419539932495184e+01 5.579771610975916474e+01 8.473706218398866952e+01 1.059842044656998041e+02 1.239312461010759137e+02 1.187199498112793492e+02 9.213599301706204869e+01 5.917515701836581599e+01 3.503192722168834194e+01 1.266306628376971410e+01 1.276937937111805610e+01
1.276937937111805610e+01 1.276937937111805610e+01 1.276937937111805610e+01 1.276937937111805610e+01 1.276937937111805610e+01 1.276937937111805610e+01 1.276937937111805610e+01 1.346185382475593961e+01 2.024262848225557221e+01 3.551114776451512967e+01 6.402175548994188148e+01 9.061351821465166267e+01 1.149394012836173715e+02 1.187199498112793492e+02 1.076187731729475416e+02 7.722304358575991046e+01 5.010477779974139168e+01 2.429634394861078661e+01 1.266306628376971410e+01 1.276937937111805610e+01
1.276937937111805610e+01 1.276937937111805610e+01 1.276937937111805610e+01 1.276937937111805610e+01 1.276937937111805610e+01 1.276937937111805610e+01 1.229118975302313999e+01 1.781634386159733197e+01 2.844415493163317876e+01 4.544930672814309958e+01 7.830365895959157285e+01 1.024902229814814092e+02 1.114412563448850904e+02 1.187199498112793492e+02 9.213599301706204869e+01 7.163093108848082124e+01 4.170744108265041916e+01 2.200210093066193906e+01 1.425081808425233909e+01 1.276937937111805610e+01
1.276937937111805610e+01 1.276937937111805610e+01 1.276937937111805610e+01 1.276937937111805610e+01 1.276937937111805610e+01 1.276937937111805610e+01 1.913160921205490439e+01 2.226924051535441151e+01 3.551114776451512967e+01 6.536620077422095676e+01 9.061351821465166267e+01 1.149394012836173715e+02 1.187199498112793492e+02 1.076187731729475416e+02 7.989391299298169713e+01 5.280497634287794995e+01 3.115935455162107459e+01 1.266306628376971410e+01 1.276937937111805610e+01 1.276937937111805610e+01
1.276937937111805610e+01 1.276937937111805610e+01 1.276937937111805610e+01 1.276937937111805610e+01 1.276937937111805610e+01 1.346185382475593961e+01 2.024262848225557221e+01 3.551114776451512967e+01 5.579771610975916474e+01 8.473706218398866952e+01 1.024902229814814092e+02 1.209469427973171349e+02 1.076187731729475416e+02 9.213599301706204869e+01 6.784284249974980696e+01 4.170744108265041916e+01 2.200210093066193906e+01 1.425081808425233909e+01 1.276937937111805610e+01 1.276937937111805610e+01
1.276937937111805610e+01 1.276937937111805610e+01 1.276937937111805610e+01 1.276937937111805610e+01 1.276937937111805610e+01 1.913160921205490439e+01 2.844415493163317876e+01 4.544930672814309958e+01 7.524068430535901086e+01 1.006072803180406368e+02 1.114412563448850904e+02 1.187199498112793492e+02 9.213599301706204869e+01 7.163093108848082124e+01 4.170744108265041916e+01 3.115935455162107459e+01 1.266306628376971410e+01 1.276937937111805610e+01 1.276937937111805610e+01 1.276937937111805610e+01
1.276937937111805610e+01 1.276937937111805610e+01 1.276937937111805610e+01 1.276937937111805610e+01 1.229118975302313999e+01 2.107041946530724275e+01 3.551114776451512967e+01 6.536620077422095676e+01 8.473706218398866952e+01 1.074349739929945571e+02 1.187199498112793492e+02 9.605063657711086478e+01 7.989391299298169713e+01 5.280497634287794995e+01 3.115935455162107459e+01 1.763776471195371087e+01 1.425081808425233909e+01 1.276937937111805610e+01 1.276937937111805610e+01 1.276937937111805610e+01
1.276937937111805610e+01 1.276937937111805610e+01 1.276937937111805610e+01 1.229118975302313999e+01 1.913160921205490439e+01 3.551114776451512967e+01 5.579771610975916474e+01 8.473706218398866952e+01 1.024902229814814092e+02 1.114412563448850904e+02 1.076187731729475416e+02 8.461010262780149560e+01 5.917515701836581599e+01 4.170744108265041916e+01 2.200210093066193906e+01 1.266306628376971410e+01 1.276937937111805610e+01 1.276937937111805610e+01 1.276937937111805610e+01 1.276937937111805610e+01
1.276937937111805610e+01 1.276937937111805610e+01 1.276937937111805610e+01 1.624541138711696675e+01 2.107041946530724275e+01 4.544930672814309958e+01 6.536620077422095676e+01 9.455339789055852862e+01 1.074349739929945571e+02 1.048833985899646848e+02 9.213599301706204869e+01 7.163093108848082124e+01 4.170744108265041916e+01 2.200210093066193906e+01 1.266306628376971410e+01 1.276937937111805610e+01 1.276937937111805610e+01 1.276937937111805610e+01 1.276937937111805610e+01 1.276937937111805610e+01
1.276937937111805610e+01 1.276937937111805610e+01 1.276937937111805610e+01 1.624541138711696675e+01 2.844415493163317876e+01 5.579771610975916474e+01 8.473706218398866952e+01 1.006072803180406368e+02 1.114412563448850904e+02 9.605063657711086478e+01 7.163093108848082124e+01 4.388741573118951322e+01 3.115935455162107459e+01 2.200210093066193906e+01 1.276937937111805610e+01 1.276937937111805610e+01 1.276937937111805610e+01 1.276937937111805610e+01 1.276937937111805610e+01 1.276937937111805610e+01
1.276937937111805610e+01 1.276937937111805610e+01 1.276937937111805610e+01 2.226924051535441151e+01 3.551114776451512967e+01 6.182424287685249453e+01 9.061351821465166267e+01 1.048833985899646848e+02 9.326425795060011126e+01 7.163093108848082124e+01 5.074317478749004806e+01 3.115935455162107459e+01 1.763776471195371087e+01 1.266306628376971410e+01 1.276937937111805610e+01 1.276937937111805610e+01 1.276937937111805610e+01 1.276937937111805610e+01 1.276937937111805610e+01 1.276937937111805610e+01
