1.108435091632358827e+01 1.108435091632358827e+01 1.108435091632358827e+01 1.108435091632358827e+01 1.108435091632358827e+01 1.231590930320482613e+01 1.231590930320482613e+01 1.231590930320482613e+01 1.231590930320482613e+01 1.231590930320482613e+01 1.231590930320482613e+01 1.782192444133020715e+01 2.228844212761229926e+01 2.331224037073984334e+01 2.331224037073984334e+01 2.435358232554864699e+01 1.833912438363422481e+01 1.108435091632358827e+01 1.108435091632358827e+01 1.108435091632358827e+01
1.108435091632358827e+01 1.108435091632358827e+01 1.108435091632358827e+01 1.108435091632358827e+01 1.231590930320482613e+01 1.231590930320482613e+01 2.157274991256413799e+01 2.331224037073984334e+01 1.833912438363422481e+01 1.833912438363422481e+01 1.944660412001407224e+01 2.244694215385124991e+01 2.647703312799494313e+01 3.460194875211547583e+01 3.020508299100718475e+01 3.317504531349397467e+01 2.215983881438790348e+01 1.268114765124931154e+01 1.108435091632358827e+01 1.108435091632358827e+01
1.108435091632358827e+01 1.108435091632358827e+01 1.108435091632358827e+01 1.108435091632358827e+01 1.231590930320482613e+01 2.244694215385124991e+01 2.647703312799494313e+01 3.217991250445952289e+01 3.020508299100718475e+01 2.435358232554864699e+01 2.358588761715917315e+01 2.578301684661517257e+01 3.971280382745302262e+01 4.837556363799873793e+01 4.550903675340295962e+01 3.847259083983578876e+01 2.215983881438790348e+01 1.268114765124931154e+01 1.108435091632358827e+01 1.108435091632358827e+01
1.108435091632358827e+01 1.108435091632358827e+01 1.108435091632358827e+01 1.231590930320482613e+01 2.024387962005480190e+01 2.578301684661517257e+01 3.971280382745302262e+01 3.733481375161598947e+01 4.550903675340295962e+01 3.317504531349397467e+01 2.493925190483589915e+01 2.944229763992735371e+01 4.749977039626669750e+01 6.562895074333847845e+01 5.659209984140741767e+01 3.871134169956698656e+01 2.349588633926480696e+01 1.268114765124931154e+01 1.108435091632358827e+01 1.108435091632358827e+01
1.108435091632358827e+01 1.108435091632358827e+01 1.108435091632358827e+01 1.231590930320482613e+01 2.244694215385124991e+01 3.158377771282566115e+01 4.271762739146458898e+01 5.355650812639631653e+01 4.526526528250447967e+01 3.847259083983578876e+01 2.586899237979852373e+01 4.271762739146458898e+01 5.624020283650455099e+01 6.983413591308571711e+01 5.659209984140741767e+01 3.886163885800823437e+01 2.349588633926480696e+01 1.268114765124931154e+01 1.108435091632358827e+01 1.108435091632358827e+01
1.108435091632358827e+01 1.108435091632358827e+01 1.108435091632358827e+01 1.297598914686809302e+01 2.354932955615589307e+01 4.317102658572227369e+01 5.624020283650455099e+01 5.670891700290884785e+01 5.659209984140741767e+01 3.847259083983578876e+01 2.915398363438473339e+01 4.517902164661162345e+01 6.649855471353322400e+01 7.096378421986446483e+01 6.039662771986459688e+01 3.886163885800823437e+01 2.469940237281809559e+01 1.268114765124931154e+01 1.108435091632358827e+01 1.108435091632358827e+01
1.108435091632358827e+01 1.108435091632358827e+01 1.231590930320482613e+01 2.024387962005480190e+01 3.000190069451637953e+01 4.837556363799873793e+01 6.562895074333847845e+01 6.983413591308571711e+01 5.438610504708051963e+01 3.847259083983578876e+01 3.267821547614182265e+01 4.966631321066748939e+01 6.562895074333847845e+01 7.565945608136961198e+01 6.039662771986459688e+01 3.886163885800823437e+01 2.320753906356998186e+01 1.268114765124931154e+01 1.108435091632358827e+01 1.108435091632358827e+01
1.108435091632358827e+01 1.108435091632358827e+01 1.231590930320482613e+01 2.395151746313472430e+01 3.571751373376611838e+01 5.624020283650455099e+01 7.096378421986446483e+01 6.983413591308571711e+01 5.438610504708051963e+01 4.526526528250447967e+01 5.355650812639631653e+01 6.562895074333847845e+01 7.812231558200249992e+01 7.565945608136961198e+01 5.535691785731626879e+01 3.291512858136679398e+01 2.100240874506543065e+01 1.108435091632358827e+01 1.108435091632358827e+01 1.108435091632358827e+01
1.108435091632358827e+01 1.108435091632358827e+01 1.701099804544845639e+01 2.820633444025110492e+01 4.789611411850530232e+01 6.971853333699193911e+01 8.504311366222469815e+01 7.474645782807657213e+01 7.156330909665422269e+01 5.670891700290884785e+01 6.562895074333847845e+01 7.812231558200249992e+01 8.831996636302126547e+01 8.353480429705280130e+01 5.535691785731626879e+01 2.957240729142735702e+01 1.268114765124931154e+01 1.108435091632358827e+01 1.108435091632358827e+01 1.108435091632358827e+01
1.108435091632358827e+01 1.231590930320482613e+01 2.024387962005480190e+01 3.000190069451637953e+01 5.395828185218518769e+01 7.683501484104564838e+01 8.938120058623300679e+01 9.180163002318921883e+01 8.044951472265987036e+01 7.895148659788326029e+01 8.541614062374534910e+01 9.277285551995845481e+01 9.004563991777052934e+01 7.321789376894894019e+01 5.185884313904862353e+01 2.753561903735074878e+01 1.268114765124931154e+01 1.108435091632358827e+01 1.108435091632358827e+01 1.108435091632358827e+01
1.108435091632358827e+01 1.231590930320482613e+01 2.084971321552747270e+01 3.571751373376611838e+01 5.608088334407401021e+01 7.285596101788519263e+01 8.787408159467743474e+01 8.787408159467743474e+01 9.071426645303105829e+01 9.071426645303105829e+01 9.793237726775510055e+01 1.023483319374468010e+02 9.880250422783942099e+01 7.532092102791585830e+01 4.622519163487361737e+01 2.469940237281809559e+01 1.268114765124931154e+01 1.108435091632358827e+01 1.108435091632358827e+01 1.108435091632358827e+01
1.108435091632358827e+01 1.339806016631762731e+01 2.084971321552747270e+01 2.852856661698719165e+01 4.881672705296045933e+01 6.167508371107597753e+01 7.528404353372417290e+01 7.528404353372417290e+01 8.049072613337135351e+01 9.304352647469031012e+01 9.764740920362447696e+01 1.058922952777142115e+02 8.848947751150174668e+01 6.624791955286849543e+01 3.886163885800823437e+01 2.349588633926480696e+01 1.268114765124931154e+01 1.108435091632358827e+01 1.108435091632358827e+01 1.108435091632358827e+01
1.108435091632358827e+01 1.108435091632358827e+01 1.701099804544845639e+01 2.502642513482237163e+01 3.383034118385963751e+01 4.615819526522459171e+01 5.640785542505833661e+01 5.640785542505833661e+01 5.640785542505833661e+01 7.285596101788519263e+01 7.992423938359198132e+01 9.304352647469031012e+01 8.275179857957216711e+01 5.891354129768262737e+01 3.587973719959103391e+01 2.215983881438790348e+01 1.268114765124931154e+01 1.108435091632358827e+01 1.108435091632358827e+01 1.108435091632358827e+01
1.108435091632358827e+01 1.108435091632358827e+01 1.339806016631762731e+01 1.701099804544845639e+01 2.502642513482237163e+01 3.383034118385963751e+01 3.661064988801934561e+01 3.985647777723909968e+01 4.378140533994993433e+01 6.167508371107597753e+01 7.992423938359198132e+01 8.787408159467743474e+01 7.321789376894894019e+01 5.185884313904862353e+01 3.435633173668113471e+01 1.268114765124931154e+01 1.108435091632358827e+01 1.108435091632358827e+01 1.108435091632358827e+01 1.108435091632358827e+01
1.108435091632358827e+01 1.108435091632358827e+01 1.108435091632358827e+01 1.339806016631762731e+01 1.339806016631762731e+01 1.339806016631762731e+01 2.179844235681931153e+01 2.513535345167399981e+01 3.237811422061866296e+01 4.789611411850530232e+01 7.128003092135391228e+01 7.565945608136961198e+01 6.845849096927206290e+01 4.622519163487361737e+01 2.753561903735074878e+01 1.268114765124931154e+01 1.108435091632358827e+01 1.108435091632358827e+01 1.108435091632358827e+01 1.108435091632358827e+01
1.108435091632358827e+01 1.108435091632358827e+01 1.108435091632358827e+01 1.108435091632358827e+01 1.108435091632358827e+01 1.339806016631762731e+01 1.339806016631762731e+01 2.024387962005480190e+01 2.944229763992735371e+01 5.608088334407401021e+01 7.128003092135391228e+01 7.565945608136961198e+01 6.624791955286849543e+01 3.886163885800823437e+01 2.320753906356998186e+01 1.268114765124931154e+01 1.108435091632358827e+01 1.108435091632358827e+01 1.108435091632358827e+01 1.108435091632358827e+01
1.108435091632358827e+01 1.108435091632358827e+01 1.108435091632358827e+01 1.108435091632358827e+01 1.108435091632358827e+01 1.108435091632358827e+01 1.231590930320482613e+01 2.244694215385124991e+01 3.571751373376611838e+01 5.728803149082794732e+01 7.128003092135391228e+01 7.565945608136961198e+01 6.039662771986459688e+01 3.587973719959103391e+01 2.320753906356998186e+01 1.268114765124931154e+01 1.108435091632358827e+01 1.108435091632358827e+01 1.108435091632358827e+01 1.108435091632358827e+01
1.108435091632358827e+01 1.108435091632358827e+01 1.108435091632358827e+01 1.108435091632358827e+01 1.108435091632358827e+01 1.108435091632358827e+01 1.297598914686809302e+01 2.395151746313472430e+01 4.068040303065372854e+01 6.649855471353322400e+01 7.948115067074107287e+01 8.353480429705280130e+01 5.535691785731626879e+01 3.291512858136679398e+01 2.100240874506543065e+01 1.108435091632358827e+01 1.108435091632358827e+01 1.108435091632358827e+01 1.108435091632358827e+01 1.108435091632358827e+01
1.108435091632358827e+01 1.108435091632358827e+01 1.108435091632358827e+01 1.108435091632358827e+01 1.108435091632358827e+01 1.108435091632358827e+01 1.297598914686809302e+01 2.395151746313472430e+01 4.052086698871409709e+01 6.769048670333923212e+01 7.652111338826723852e+01 6.845849096927206290e+01 5.185884313904862353e+01 2.753561903735074878e+01 1.268114765124931154e+01 1.108435091632358827e+01 1.108435091632358827e+01 1.108435091632358827e+01 1.108435091632358827e+01 1.108435091632358827e+01
1.108435091632358827e+01 1.108435091632358827e+01 1.108435091632358827e+01 1.108435091632358827e+01 1.108435091632358827e+01 1.108435091632358827e+01 1.701099804544845639e+01 2.395151746313472430e+01 4.052086698871409709e+01 5.883379217075955125e+01 7.104808467187430665e+01 5.565155166041154189e+01 4.259069467819476529e+01 2.469940237281809559e+01 1.268114765124931154e+01 1.108435091632358827e+01 1.108435091632358827e+01 1.108435091632358827e+01 1.108435091632358827e+01 1.108435091632358827e+01
