1.090891631693843244e+01 1.090891631693843244e+01 1.090891631693843244e+01 1.090891631693843244e+01 1.898290830843226118e+01 2.770109289207225345e+01 4.710392412532263506e+01 6.406252860944196925e+01 7.242699805335878693e+01 8.361524039139003150e+01 8.361524039139003150e+01 8.733425669689101767e+01 7.968893809228836744e+01 6.056110159603375820e+01 4.431734316484862291e+01 2.822842623091947800e+01 2.045274082323325260e+01 1.148877029116921911e+01 1.090891631693843244e+01 1.090891631693843244e+01
1.090891631693843244e+01 1.090891631693843244e+01 1.090891631693843244e+01 1.298292415632074182e+01 2.237683476398031246e+01 3.627013378260618026e+01 5.488660019288218450e+01 7.839511471347647387e+01 9.633674588225638047e+01 9.946822208406399568e+01 9.946822208406399568e+01 9.946822208406399568e+01 9.181800789010860342e+01 8.737773010171657972e+01 6.507431132826387454e+01 4.189624614473882502e+01 2.341591879747660698e+01 1.148877029116921911e+01 1.090891631693843244e+01 1.090891631693843244e+01
1.090891631693843244e+01 1.090891631693843244e+01 1.090891631693843244e+01 1.298292415632074182e+01 2.353716881851157439e+01 3.912819862698297868e+01 6.168811268288132510e+01 7.910866619247029519e+01 8.806139973898164897e+01 9.856492053074865112e+01 9.768699831221876195e+01 9.768699831221876195e+01 1.012510241288748887e+02 9.666675597716454149e+01 7.592361846374170398e+01 5.737569223120820538e+01 2.707011226733420983e+01 2.045274082323325260e+01 1.148877029116921911e+01 1.090891631693843244e+01
1.090891631693843244e+01 1.090891631693843244e+01 1.090891631693843244e+01 1.090891631693843244e+01 2.085704346369211137e+01 3.485317122788086408e+01 5.107745186622668143e+01 6.307927180890533236e+01 6.772810066084508662e+01 6.772810066084508662e+01 6.772810066084508662e+01 8.559466602443458783e+01 9.765652219451320093e+01 1.012510241288748887e+02 8.687376714360451047e+01 5.737569223120820538e+01 3.592703397906297624e+01 2.169233731671396370e+01 1.148877029116921911e+01 1.090891631693843244e+01
1.090891631693843244e+01 1.090891631693843244e+01 1.090891631693843244e+01 1.090891631693843244e+01 1.460665488214961449e+01 2.469147365312298703e+01 3.379701954420713861e+01 4.560082086381255095e+01 4.662866421502880598e+01 4.934547459608204178e+01 5.810271397554681272e+01 7.225732157984663218e+01 9.471767423987976997e+01 1.014014951063435177e+02 8.674695502195203289e+01 6.639797360379303370e+01 3.680746008479395215e+01 2.165096377748534451e+01 1.265120113150370607e+01 1.090891631693843244e+01
1.090891631693843244e+01 1.090891631693843244e+01 1.090891631693843244e+01 1.090891631693843244e+01 1.090891631693843244e+01 2.091349568369396650e+01 2.482414283412323641e+01 3.297160855021903103e+01 4.149810085390046765e+01 4.149810085390046765e+01 5.747846036044393259e+01 7.839511471347647387e+01 9.424477177573179176e+01 1.080278294371835699e+02 9.609857398526509087e+01 6.639797360379303370e+01 4.082534660471909405e+01 2.165096377748534451e+01 1.265120113150370607e+01 1.090891631693843244e+01
1.090891631693843244e+01 1.090891631693843244e+01 1.090891631693843244e+01 1.148877029116921911e+01 1.513667193724102411e+01 2.309310421590099338e+01 2.811842430184293562e+01 3.793701166723663931e+01 5.148526390589255897e+01 5.802503156858293210e+01 7.769861390130390078e+01 9.132353764593966616e+01 1.084044601116189739e+02 1.144974682406378292e+02 9.957466110354205568e+01 7.440326696388322603e+01 4.448541267552365497e+01 2.165096377748534451e+01 1.265120113150370607e+01 1.090891631693843244e+01
1.090891631693843244e+01 1.090891631693843244e+01 1.148877029116921911e+01 1.513667193724102411e+01 2.374398581949679254e+01 3.559975825838014885e+01 5.293401978478701153e+01 6.406252860944196925e+01 7.769861390130390078e+01 8.242263072285476255e+01 9.707125572540215330e+01 1.137549591753704874e+02 1.216682699241003149e+02 1.241922568559751312e+02 1.091192021605191371e+02 8.247001941657859447e+01 4.937488817870156055e+01 2.707011226733420983e+01 1.265120113150370607e+01 1.090891631693843244e+01
1.090891631693843244e+01 1.090891631693843244e+01 1.090891631693843244e+01 2.237683476398031246e+01 3.681348424584469115e+01 5.543890674501921012e+01 7.404272727734991122e+01 9.132353764593966616e+01 1.029133232995054783e+02 1.117715514250785560e+02 1.153737889347948027e+02 1.223698217927738625e+02 1.266995529012107795e+02 1.266995529012107795e+02 1.091192021605191371e+02 8.247001941657859447e+01 5.737569223120820538e+01 2.873990598304915878e+01 2.045274082323325260e+01 1.148877029116921911e+01
1.090891631693843244e+01 1.148877029116921911e+01 1.513667193724102411e+01 2.825482377842292792e+01 4.883780022111327668e+01 6.846609799246083128e+01 9.352315737640439863e+01 1.070607418070674299e+02 1.153737889347948027e+02 1.142684915862874817e+02 1.121184709846179288e+02 1.187434759920252958e+02 1.187434759920252958e+02 1.237101580030153656e+02 1.152933835543909140e+02 9.029288949445700041e+01 5.737569223120820538e+01 3.577482605217533518e+01 2.169233731671396370e+01 1.148877029116921911e+01
1.090891631693843244e+01 1.090891631693843244e+01 1.898290830843226118e+01 2.902424726939955235e+01 5.070485266870429086e+01 7.641703316556741754e+01 9.600246312839486507e+01 1.063904798206014277e+02 1.047738185740964951e+02 1.047738185740964951e+02 9.115313933642123345e+01 9.115313933642123345e+01 1.031002805980080836e+02 1.113674589718777383e+02 1.160952429364543690e+02 9.029288949445700041e+01 6.639797360379303370e+01 4.082534660471909405e+01 2.165096377748534451e+01 1.265120113150370607e+01
1.090891631693843244e+01 1.090891631693843244e+01 1.858848523540487463e+01 2.749195228649502454e+01 4.059568938348139966e+01 6.307927180890533236e+01 7.661949822627201456e+01 8.326412216751359097e+01 8.174764197364223151e+01 6.877553512660036006e+01 6.772810066084508662e+01 6.772810066084508662e+01 8.319759886978050645e+01 9.963032403859092767e+01 1.045143549630554816e+02 9.029288949445700041e+01 6.708016137390123390e+01 3.774763193226741009e+01 2.165096377748534451e+01 1.265120113150370607e+01
1.090891631693843244e+01 1.090891631693843244e+01 1.090891631693843244e+01 2.469147365312298703e+01 3.379701954420713861e+01 4.560082086381255095e+01 5.142410790055122050e+01 5.113696424142695918e+01 4.934547459608204178e+01 4.934547459608204178e+01 4.662866421502880598e+01 6.472285075899918638e+01 8.166381744462157144e+01 9.471767423987976997e+01 1.045143549630554816e+02 9.029288949445700041e+01 5.906828601394292377e+01 3.587736103674343013e+01 2.165096377748534451e+01 1.265120113150370607e+01
1.090891631693843244e+01 1.090891631693843244e+01 1.090891631693843244e+01 1.460665488214961449e+01 2.290552436149128823e+01 2.846196832584900704e+01 2.846196832584900704e+01 3.078073668027800025e+01 3.024178576108947425e+01 3.297160855021903103e+01 4.149810085390046765e+01 5.998548665701476779e+01 8.396213982721074842e+01 9.846268817369701765e+01 1.035128937191947784e+02 8.271951569291614703e+01 5.428408698336692595e+01 3.081262058670743897e+01 2.009839063269585679e+01 1.090891631693843244e+01
1.148877029116921911e+01 1.148877029116921911e+01 1.148877029116921911e+01 1.930331983906824789e+01 1.930331983906824789e+01 2.224899666493040229e+01 2.224899666493040229e+01 2.561422604584198481e+01 3.340750284599266706e+01 4.201590476081225489e+01 5.827973826518965694e+01 7.928897002604557542e+01 9.331643752999001151e+01 1.045143549630554816e+02 9.486775181974103077e+01 6.893120094374867790e+01 4.573935375086551858e+01 2.368578414005839150e+01 1.265120113150370607e+01 1.090891631693843244e+01
1.513667193724102411e+01 2.230506501927262519e+01 2.642750068688791742e+01 2.907060464540764144e+01 3.252418939272668297e+01 3.252418939272668297e+01 3.499624606326418075e+01 3.825276850249189664e+01 5.148526390589255897e+01 5.802503156858293210e+01 7.769861390130390078e+01 9.221231412679426853e+01 1.023488544844514649e+02 9.593646970618932812e+01 8.346867900692990361e+01 5.938846681289650320e+01 3.324720773253786632e+01 2.351640075703397770e+01 1.265120113150370607e+01 1.090891631693843244e+01
1.990596944687126424e+01 3.453351668705590782e+01 4.851721019693122372e+01 5.703021172563459373e+01 5.787828995443598501e+01 6.200358480646261228e+01 6.200358480646261228e+01 6.406252860944196925e+01 7.451852821981542263e+01 8.491477236690222696e+01 9.707125572540215330e+01 1.023488544844514649e+02 9.522941542167465911e+01 8.321140992094018429e+01 6.291512300154379744e+01 4.293631403116486212e+01 2.553200150773083976e+01 1.779960086878999093e+01 1.090891631693843244e+01 1.090891631693843244e+01
2.825482377842292792e+01 4.340745079491230740e+01 6.181344965066297448e+01 7.938718570011009490e+01 8.361524039139003150e+01 8.678977319723087192e+01 8.361524039139003150e+01 9.221231412679426853e+01 9.777217914921146757e+01 9.946822208406399568e+01 1.049249792089117932e+02 9.325902901775285159e+01 8.285472123069240524e+01 6.568058789421790777e+01 4.293631403116486212e+01 2.553200150773083976e+01 2.009839063269585679e+01 1.265120113150370607e+01 1.090891631693843244e+01 1.090891631693843244e+01
2.902424726939955235e+01 4.816211823812660953e+01 7.641703316556741754e+01 9.062948864649264635e+01 9.946822208406399568e+01 9.986906430922687150e+01 9.986906430922687150e+01 9.986906430922687150e+01 9.522941542167465911e+01 9.522941542167465911e+01 8.174764197364223151e+01 7.345508281287523289e+01 5.691762766944562912e+01 3.965131313538473989e+01 2.982301533422673856e+01 2.009839063269585679e+01 1.265120113150370607e+01 1.090891631693843244e+01 1.090891631693843244e+01 1.090891631693843244e+01
2.749195228649502454e+01 4.280150512949052910e+01 6.307927180890533236e+01 8.455466367769048475e+01 8.652408755966405352e+01 8.528264359202880485e+01 8.652408755966405352e+01 8.326412216751359097e+01 7.887452111835087010e+01 6.877553512660036006e+01 5.691762766944562912e+01 4.976648894151797009e+01 4.010867624457574721e+01 2.553200150773083976e+01 2.009839063269585679e+01 1.265120113150370607e+01 1.090891631693843244e+01 1.090891631693843244e+01 1.090891631693843244e+01 1.090891631693843244e+01
