1.098181413749908408e+01 1.098181413749908408e+01 1.098181413749908408e+01 1.098181413749908408e+01 1.098181413749908408e+01 1.098181413749908408e+01 1.098181413749908408e+01 1.098181413749908408e+01 1.232294506054313743e+01 1.898119905603139657e+01 2.154397596343022769e+01 2.154397596343022769e+01 2.486176243511298978e+01 2.486176243511298978e+01 2.486176243511298978e+01 2.425629628545075889e+01 2.036064938072678387e+01 1.232294506054313743e+01 1.098181413749908408e+01 1.098181413749908408e+01
1.098181413749908408e+01 1.098181413749908408e+01 1.098181413749908408e+01 1.098181413749908408e+01 1.098181413749908408e+01 1.098181413749908408e+01 1.098181413749908408e+01 1.898119905603139657e+01 2.154397596343022769e+01 2.778182117069773938e+01 3.206141830708650531e+01 3.206141830708650531e+01 3.969917269466772325e+01 3.969917269466772325e+01 3.969917269466772325e+01 3.261402268888410561e+01 2.800486788453951803e+01 2.202509809513988870e+01 1.232294506054313743e+01 1.098181413749908408e+01
1.098181413749908408e+01 1.098181413749908408e+01 1.098181413749908408e+01 1.098181413749908408e+01 1.098181413749908408e+01 1.232294506054313743e+01 1.898119905603139657e+01 2.363488105448332277e+01 3.346736701775196821e+01 3.805855596367189975e+01 4.635259764497359924e+01 4.635259764497359924e+01 4.635259764497359924e+01 4.635259764497359924e+01 4.635259764497359924e+01 4.635259764497359924e+01 3.848080286129952299e+01 2.772480485986402599e+01 2.202509809513988870e+01 1.098181413749908408e+01
1.098181413749908408e+01 1.098181413749908408e+01 1.098181413749908408e+01 1.098181413749908408e+01 1.098181413749908408e+01 1.898119905603139657e+01 2.778182117069773938e+01 3.346736701775196821e+01 4.482716512494886274e+01 5.618269572427325897e+01 5.414540350894801435e+01 5.414540350894801435e+01 5.414540350894801435e+01 5.414540350894801435e+01 5.498038226031355435e+01 5.289896652465580473e+01 5.442886943919096865e+01 3.848080286129952299e+01 2.202509809513988870e+01 1.398769667877241574e+01
1.098181413749908408e+01 1.098181413749908408e+01 1.098181413749908408e+01 1.098181413749908408e+01 1.898119905603139657e+01 2.354237111229262425e+01 3.346736701775196821e+01 4.703616886204436298e+01 5.618269572427325897e+01 6.080618449977151130e+01 5.216295948627143986e+01 4.659803228114409990e+01 4.172559555304023604e+01 4.741108219668014812e+01 5.498038226031355435e+01 5.790058845687978106e+01 5.372113904943980600e+01 3.728413730454449393e+01 2.398047375407438153e+01 1.398769667877241574e+01
1.098181413749908408e+01 1.098181413749908408e+01 1.098181413749908408e+01 1.098181413749908408e+01 1.988600114128365703e+01 3.158377771282566115e+01 4.703616886204436298e+01 5.883195351084997071e+01 6.092376711545978196e+01 5.420577560772971282e+01 4.306775276712747313e+01 3.550230245123444206e+01 3.465348643608783163e+01 3.757539338346893487e+01 4.904502340449872122e+01 6.080618449977151130e+01 5.372113904943980600e+01 3.534931692274859927e+01 2.367749749401147241e+01 1.398769667877241574e+01
1.098181413749908408e+01 1.098181413749908408e+01 1.098181413749908408e+01 1.898119905603139657e+01 2.679290715095006803e+01 4.391349752179471011e+01 5.618269572427325897e+01 6.080618449977151130e+01 5.372113904943980600e+01 3.656100763659083697e+01 3.198623381893323980e+01 3.133688844682517782e+01 3.269854280258574875e+01 4.482716512494886274e+01 5.618269572427325897e+01 5.289896652465580473e+01 4.716583431237563673e+01 3.534931692274859927e+01 2.321719105125633575e+01 1.232294506054313743e+01
1.098181413749908408e+01 1.098181413749908408e+01 1.098181413749908408e+01 1.898119905603139657e+01 3.479976802350768850e+01 4.904502340449872122e+01 6.460339590466168147e+01 6.183646466155793320e+01 4.716583431237563673e+01 3.868275801220389098e+01 3.733481375161598947e+01 3.638539076866680233e+01 4.725744620526884177e+01 5.618269572427325897e+01 6.080618449977151130e+01 5.372113904943980600e+01 4.207327275251549992e+01 2.708396319431463084e+01 1.398769667877241574e+01 1.098181413749908408e+01
1.098181413749908408e+01 1.098181413749908408e+01 1.355269850670860698e+01 2.090783292994696296e+01 3.479976802350768850e+01 4.904502340449872122e+01 6.460339590466168147e+01 6.524940648592205150e+01 5.442886943919096865e+01 4.929010723282313222e+01 4.541753885856974193e+01 5.124706022649525750e+01 5.618269572427325897e+01 6.080618449977151130e+01 6.092376711545978196e+01 4.306775276712747313e+01 3.147760607835941116e+01 2.507718446210245489e+01 1.098181413749908408e+01 1.098181413749908408e+01
1.098181413749908408e+01 1.098181413749908408e+01 1.393458126591851709e+01 2.090783292994696296e+01 3.383938986704588814e+01 4.881672705296045933e+01 6.460339590466168147e+01 6.638469088263744311e+01 6.638469088263744311e+01 5.498038226031355435e+01 5.751169175027405345e+01 6.205768241738108770e+01 6.985083031709044121e+01 6.183646466155793320e+01 5.420577560772971282e+01 3.530738135586969406e+01 2.521641010348762535e+01 1.398769667877241574e+01 1.098181413749908408e+01 1.098181413749908408e+01
1.098181413749908408e+01 1.098181413749908408e+01 1.098181413749908408e+01 1.393458126591851709e+01 2.749142178355513977e+01 4.280925302017612921e+01 5.688312356916659951e+01 5.790058845687978106e+01 6.431467521815842758e+01 6.431467521815842758e+01 6.985083031709044121e+01 7.622734929973788098e+01 7.630831617099994446e+01 6.092376711545978196e+01 4.277353276790253744e+01 2.655180726855720152e+01 1.398769667877241574e+01 1.098181413749908408e+01 1.098181413749908408e+01 1.098181413749908408e+01
1.098181413749908408e+01 1.098181413749908408e+01 1.098181413749908408e+01 1.393458126591851709e+01 2.090783292994696296e+01 3.187637608557330182e+01 4.080342231552256749e+01 5.265596344789589267e+01 6.017403717552162590e+01 6.741211037146427998e+01 7.147260553445472908e+01 7.551555641751915005e+01 6.845849096927206290e+01 5.236081561962652131e+01 3.425671949316976850e+01 2.295191157559921180e+01 1.098181413749908408e+01 1.098181413749908408e+01 1.098181413749908408e+01 1.098181413749908408e+01
1.098181413749908408e+01 1.098181413749908408e+01 1.098181413749908408e+01 1.098181413749908408e+01 1.393458126591851709e+01 2.629631638515819958e+01 3.234404936558343735e+01 4.080342231552256749e+01 4.881672705296045933e+01 6.741211037146427998e+01 7.104448040207768145e+01 7.630831617099994446e+01 5.887490905342765046e+01 4.277353276790253744e+01 2.553674974168561107e+01 1.398769667877241574e+01 1.098181413749908408e+01 1.098181413749908408e+01 1.098181413749908408e+01 1.098181413749908408e+01
1.098181413749908408e+01 1.098181413749908408e+01 1.098181413749908408e+01 1.098181413749908408e+01 1.098181413749908408e+01 1.393458126591851709e+01 2.135332276556127695e+01 3.049324952911155862e+01 4.904502340449872122e+01 6.460339590466168147e+01 7.104448040207768145e+01 5.807081860206532298e+01 4.277353276790253744e+01 3.166021496948101444e+01 2.295191157559921180e+01 1.098181413749908408e+01 1.098181413749908408e+01 1.098181413749908408e+01 1.098181413749908408e+01 1.098181413749908408e+01
1.098181413749908408e+01 1.098181413749908408e+01 1.098181413749908408e+01 1.098181413749908408e+01 1.098181413749908408e+01 1.355269850670860698e+01 1.988600114128365703e+01 3.757539338346893487e+01 4.904502340449872122e+01 6.460339590466168147e+01 6.092376711545978196e+01 4.972510631450868601e+01 3.166021496948101444e+01 2.295191157559921180e+01 1.398769667877241574e+01 1.098181413749908408e+01 1.098181413749908408e+01 1.098181413749908408e+01 1.098181413749908408e+01 1.098181413749908408e+01
1.098181413749908408e+01 1.098181413749908408e+01 1.098181413749908408e+01 1.098181413749908408e+01 1.098181413749908408e+01 1.898119905603139657e+01 2.679290715095006803e+01 4.317102658572227369e+01 5.618269572427325897e+01 6.080618449977151130e+01 5.420577560772971282e+01 3.891414668209541361e+01 2.553674974168561107e+01 1.398769667877241574e+01 1.098181413749908408e+01 1.098181413749908408e+01 1.232294506054313743e+01 1.183180847592954521e+01 1.098181413749908408e+01 1.098181413749908408e+01
1.098181413749908408e+01 1.098181413749908408e+01 1.098181413749908408e+01 1.098181413749908408e+01 1.898119905603139657e+01 2.370973631851044061e+01 3.682371981202565792e+01 5.337780855098090171e+01 5.883195351084997071e+01 5.807081860206532298e+01 4.277353276790253744e+01 2.986381668141012113e+01 1.398769667877241574e+01 1.098181413749908408e+01 1.232294506054313743e+01 1.898119905603139657e+01 1.833161885113718981e+01 1.833161885113718981e+01 1.232294506054313743e+01 1.098181413749908408e+01
1.098181413749908408e+01 1.098181413749908408e+01 1.098181413749908408e+01 1.098181413749908408e+01 1.988600114128365703e+01 3.215025136149382945e+01 4.482716512494886274e+01 5.883195351084997071e+01 6.092376711545978196e+01 4.972510631450868601e+01 3.425671949316976850e+01 2.507718446210245489e+01 1.398769667877241574e+01 1.098181413749908408e+01 1.898119905603139657e+01 2.084077531646899573e+01 2.302425556811833474e+01 2.333540014357361159e+01 2.036064938072678387e+01 1.232294506054313743e+01
1.098181413749908408e+01 1.098181413749908408e+01 1.098181413749908408e+01 1.393458126591851709e+01 2.578301684661517257e+01 4.317102658572227369e+01 5.618269572427325897e+01 6.080618449977151130e+01 5.372113904943980600e+01 3.530738135586969406e+01 2.553674974168561107e+01 1.398769667877241574e+01 1.098181413749908408e+01 1.393458126591851709e+01 1.898119905603139657e+01 2.358731040915390764e+01 2.794091612362769794e+01 2.582805826843918950e+01 2.342817821881999407e+01 2.036064938072678387e+01
1.098181413749908408e+01 1.098181413749908408e+01 1.098181413749908408e+01 1.898119905603139657e+01 2.944229763992735371e+01 4.904502340449872122e+01 5.790058845687978106e+01 5.216295948627143986e+01 4.277353276790253744e+01 2.986381668141012113e+01 1.398769667877241574e+01 1.098181413749908408e+01 1.098181413749908408e+01 1.393458126591851709e+01 1.898119905603139657e+01 2.503601290056689166e+01 2.503601290056689166e+01 3.021614410096869463e+01 2.595728746221327299e+01 2.036064938072678387e+01
