1.091026960810459379e+01 1.091026960810459379e+01 1.091026960810459379e+01 1.091026960810459379e+01 1.513667193724102411e+01 2.230506501927262519e+01 3.243346966068229165e+01 3.793701166723663931e+01 4.415113662703367226e+01 5.385638490440257442e+01 5.787828995443598501e+01 5.787828995443598501e+01 6.406252860944196925e+01 6.579763334965480226e+01 5.482696334956748530e+01 5.822094971013117970e+01 4.162686213342543340e+01 3.261402268888410561e+01 2.341591879747660698e+01 1.148525894495275779e+01
1.091026960810459379e+01 1.091026960810459379e+01 1.091026960810459379e+01 1.898290830843226118e+01 2.671352755301215254e+01 3.793701166723663931e+01 5.293401978478701153e+01 6.406252860944196925e+01 7.451852821981542263e+01 7.894930483408020905e+01 8.361524039139003150e+01 8.361524039139003150e+01 8.361524039139003150e+01 8.361524039139003150e+01 8.361524039139003150e+01 7.968893809228836744e+01 7.056676616106132371e+01 5.855870590381934448e+01 3.893128589242299142e+01 2.341591879747660698e+01
1.091026960810459379e+01 1.091026960810459379e+01 1.898290830843226118e+01 2.926793811956777702e+01 4.396797881515495021e+01 5.802503156858293210e+01 7.769861390130390078e+01 8.361524039139003150e+01 9.071400855637313043e+01 9.071400855637313043e+01 9.946822208406399568e+01 9.909281612176035026e+01 9.456988625243440083e+01 9.909281612176035026e+01 9.976768279473095902e+01 9.685563409525816780e+01 9.181800789010860342e+01 6.759611020901610345e+01 4.354618718771538255e+01 2.887395883317374512e+01
1.091026960810459379e+01 1.091026960810459379e+01 2.379786553797185178e+01 4.139775788472844198e+01 6.181344965066297448e+01 7.938718570011009490e+01 9.708820802314477305e+01 9.847726800555551563e+01 9.620845608377416625e+01 8.528264359202880485e+01 8.528264359202880485e+01 8.652408755966405352e+01 8.652408755966405352e+01 8.528264359202880485e+01 8.528264359202880485e+01 9.306438872929622619e+01 1.012603706037070879e+02 8.686999644177959112e+01 5.737569223120820538e+01 3.516409427877179894e+01
1.091026960810459379e+01 1.997107378293504709e+01 3.160439563674137631e+01 5.503662743889419318e+01 7.921109360082573403e+01 9.776237126100710384e+01 1.045012698465284018e+02 9.593646970618932812e+01 8.321140992094018429e+01 6.879477601636341433e+01 6.772810066084508662e+01 6.772810066084508662e+01 6.046771979685294696e+01 6.046771979685294696e+01 8.033475487341382859e+01 8.514804768908054200e+01 9.314567550438434296e+01 8.686999644177959112e+01 6.111528519751449551e+01 3.592703397906297624e+01
1.091026960810459379e+01 2.218480526565863542e+01 3.919499136086479751e+01 6.808002006788251492e+01 9.321057797521244481e+01 1.080278294371835699e+02 1.020572193206312761e+02 8.461010262780149560e+01 6.063138025861452718e+01 5.164485511525170836e+01 4.662866421502880598e+01 4.662866421502880598e+01 4.662866421502880598e+01 5.272649270716090797e+01 6.993062251844790467e+01 8.211418331749418087e+01 9.314567550438434296e+01 8.028667040534335797e+01 5.891354129768262737e+01 3.772592545068774683e+01
1.297657616695162375e+01 2.091213509065212861e+01 4.068791641908065770e+01 6.808002006788251492e+01 9.675425204012546487e+01 1.080278294371835699e+02 9.670336256899190630e+01 8.274219550687182334e+01 5.195238564853176655e+01 4.511701791693864294e+01 3.639299844371780068e+01 3.732990914450463293e+01 4.460898879007234541e+01 5.905086539007541546e+01 7.279724150828415929e+01 8.639567899659888894e+01 8.649915044438404266e+01 7.538575224983350154e+01 5.297500169942210135e+01 3.081551231548089831e+01
1.091026960810459379e+01 2.091213509065212861e+01 3.912819862698297868e+01 6.168811268288132510e+01 9.160552739707708270e+01 1.061939330252281053e+02 1.011132893369093040e+02 8.168445796081245192e+01 5.855870590381934448e+01 5.448089241711756614e+01 5.787828995443598501e+01 5.482696334956748530e+01 6.579763334965480226e+01 7.575981923911486149e+01 8.520982271318494838e+01 8.508430011727419640e+01 8.351941646860940693e+01 6.388736943791850109e+01 4.155151888069813992e+01 2.368249920005213127e+01
1.091026960810459379e+01 2.091213509065212861e+01 3.763479976630730306e+01 6.168811268288132510e+01 9.160552739707708270e+01 1.061939330252281053e+02 1.011132893369093040e+02 9.439061252242548505e+01 8.889699847894233642e+01 8.449142572376588589e+01 8.449142572376588589e+01 8.361524039139003150e+01 9.586418476512459108e+01 9.416589672371084419e+01 8.524553821199205572e+01 8.601854666646357828e+01 7.040647370511656788e+01 4.683490665424223209e+01 3.284898276310684651e+01 2.377305794237934577e+01
1.091026960810459379e+01 1.513667193724102411e+01 2.749142178355513977e+01 5.640205172934702205e+01 8.166381744462157144e+01 9.764740920362447696e+01 1.187045386623370007e+02 1.104570162746866941e+02 1.113891188404837180e+02 1.104570162746866941e+02 1.117715514250785560e+02 1.177678725204786474e+02 1.156807070448449224e+02 1.156807070448449224e+02 9.957466110354205568e+01 7.580259860060492372e+01 5.236774628605353143e+01 3.324720773253786632e+01 2.377305794237934577e+01 1.265133341726745364e+01
1.091026960810459379e+01 1.297657616695162375e+01 2.493715474313448865e+01 4.501940691384128002e+01 6.808002006788251492e+01 9.361386795063755528e+01 1.124483550985090829e+02 1.216644715432537396e+02 1.241836751425526586e+02 1.219679808936806893e+02 1.219679808936806893e+02 1.340818852158935215e+02 1.307230552971309407e+02 1.217900772196004908e+02 9.923277263529156755e+01 7.440326696388322603e+01 4.648801469045948664e+01 2.655265149463724228e+01 1.983303630618666702e+01 1.091026960810459379e+01
1.091026960810459379e+01 1.297657616695162375e+01 2.091213509065212861e+01 3.504504885268649161e+01 6.168811268288132510e+01 8.950427893524502565e+01 1.100840658490610338e+02 1.206063102028625877e+02 1.202469179075084753e+02 1.121184709846179288e+02 1.121184709846179288e+02 1.252747755937627403e+02 1.237305738895993841e+02 1.217900772196004908e+02 1.091192021605191371e+02 7.616838353962739916e+01 5.737569223120820538e+01 2.887395883317374512e+01 2.203289989699594642e+01 1.148525894495275779e+01
1.091026960810459379e+01 1.297657616695162375e+01 2.218480526565863542e+01 3.919499136086479751e+01 6.808002006788251492e+01 9.675425204012546487e+01 1.080278294371835699e+02 1.089719139978535623e+02 9.754976993331239044e+01 9.754976993331239044e+01 9.768369334460885511e+01 1.063904798206014277e+02 1.113674589718777383e+02 1.113674589718777383e+02 1.088833621269854746e+02 9.338880003901110172e+01 6.507431132826387454e+01 4.021993488090814139e+01 2.341591879747660698e+01 1.148525894495275779e+01
1.091026960810459379e+01 1.297657616695162375e+01 2.346006795586196603e+01 4.788343333675526026e+01 7.478318219564164337e+01 9.396207991118529890e+01 1.002400596103037600e+02 9.325902901775285159e+01 7.345508281287523289e+01 5.847446684007483242e+01 6.533409723411541847e+01 6.772810066084508662e+01 8.559466602443458783e+01 9.768369334460885511e+01 1.061939330252281053e+02 9.666675597716454149e+01 7.616838353962739916e+01 4.835766406425123165e+01 2.707095566904435557e+01 1.265133341726745364e+01
1.091026960810459379e+01 1.513667193724102411e+01 2.721996163168342520e+01 4.883780022111327668e+01 7.562124472174360790e+01 9.722462619059621147e+01 9.766220659918060676e+01 7.538575224983350154e+01 5.580650486288243428e+01 3.724953654301575057e+01 3.618494966177502192e+01 4.675295079281255539e+01 6.155467068425413402e+01 8.514804768908054200e+01 1.007555161858179957e+02 9.874523712090589811e+01 7.580259860060492372e+01 4.844127864275660045e+01 2.707095566904435557e+01 1.265133341726745364e+01
1.091026960810459379e+01 1.513667193724102411e+01 2.902424726939955235e+01 5.545195109652075161e+01 8.166381744462157144e+01 1.004424599845317516e+02 9.666675597716454149e+01 7.440326696388322603e+01 4.835766406425123165e+01 3.535664748706932414e+01 2.920611504553075477e+01 4.130850512563701216e+01 5.809288440795142350e+01 8.211418331749418087e+01 9.626754028457227719e+01 9.178760599495525696e+01 7.580259860060492372e+01 4.844127864275660045e+01 2.655265149463724228e+01 1.265133341726745364e+01
1.091026960810459379e+01 1.513667193724102411e+01 2.749142178355513977e+01 4.914751956897092100e+01 8.166381744462157144e+01 1.021900373706692733e+02 1.012603706037070879e+02 8.373582594620543773e+01 5.855870590381934448e+01 4.097780613246419534e+01 4.275124909452586763e+01 5.331881799495909746e+01 6.840530462915802445e+01 8.639567899659888894e+01 9.039793925131542096e+01 8.351941646860940693e+01 6.388736943791850109e+01 4.155151888069813992e+01 2.368249920005213127e+01 1.265133341726745364e+01
1.091026960810459379e+01 1.091026960810459379e+01 2.493715474313448865e+01 4.501940691384128002e+01 7.225732157984663218e+01 9.764740920362447696e+01 1.012603706037070879e+02 9.685563409525816780e+01 8.168445796081245192e+01 7.056676616106132371e+01 6.579763334965480226e+01 7.451852821981542263e+01 8.512661204396221137e+01 8.833147042188174680e+01 8.601854666646357828e+01 7.040647370511656788e+01 4.962800359191603405e+01 3.324720773253786632e+01 2.055468957169695443e+01 1.265133341726745364e+01
1.091026960810459379e+01 1.091026960810459379e+01 2.091213509065212861e+01 3.497158194273895759e+01 5.902128706191970764e+01 8.033475487341382859e+01 9.764740920362447696e+01 1.012603706037070879e+02 9.685563409525816780e+01 8.987548296484114019e+01 8.987548296484114019e+01 8.520982271318494838e+01 8.833147042188174680e+01 8.092114371475599910e+01 7.377314291703029880e+01 5.501911200687596448e+01 3.556480404205751000e+01 2.368249920005213127e+01 1.265133341726745364e+01 1.091026960810459379e+01
1.091026960810459379e+01 1.091026960810459379e+01 1.091026960810459379e+01 2.820577677331711897e+01 4.059615156998538055e+01 6.330589184024300664e+01 8.319759886978050645e+01 9.768369334460885511e+01 9.768369334460885511e+01 9.266034923884629393e+01 9.456988625243440083e+01 9.456988625243440083e+01 8.321140992094018429e+01 7.345508281287523289e+01 5.316887009454573132e+01 3.556480404205751000e+01 2.553288485063696456e+01 1.779960086878999093e+01 1.091026960810459379e+01 1.091026960810459379e+01
