1.183554933884102489e+01 1.230322328889600669e+01 1.230322328889600669e+01 1.230322328889600669e+01 1.230322328889600669e+01 1.230322328889600669e+01 1.230322328889600669e+01 1.230322328889600669e+01 1.230322328889600669e+01 1.230322328889600669e+01 1.834209446069583294e+01 1.834209446069583294e+01 1.834209446069583294e+01 1.230322328889600669e+01 1.230322328889600669e+01 1.183554933884102489e+01 1.183554933884102489e+01 1.183554933884102489e+01 1.183554933884102489e+01 1.183554933884102489e+01
1.230322328889600669e+01 1.230322328889600669e+01 1.782192444133020715e+01 2.309587474134727003e+01 2.778866795536372081e+01 3.112826539133542170e+01 3.112826539133542170e+01 3.040362780818628607e+01 3.112826539133542170e+01 3.112826539133542170e+01 3.112826539133542170e+01 3.112826539133542170e+01 3.112826539133542170e+01 3.040362780818628607e+01 2.994619400143911037e+01 2.434646397494444514e+01 1.230322328889600669e+01 1.183554933884102489e+01 1.183554933884102489e+01 1.183554933884102489e+01
1.230322328889600669e+01 2.228844212761229926e+01 3.052183577209586929e+01 3.642236311279651062e+01 4.996947402542061667e+01 4.996947402542061667e+01 5.382719676515681329e+01 5.382719676515681329e+01 5.382719676515681329e+01 5.371416915998445774e+01 5.371416915998445774e+01 6.139746955315956711e+01 6.579273109626237215e+01 5.371416915998445774e+01 4.183649060533085162e+01 2.994619400143911037e+01 2.434646397494444514e+01 1.230322328889600669e+01 1.183554933884102489e+01 1.183554933884102489e+01
2.228844212761229926e+01 2.650868096517625361e+01 4.738461218978986267e+01 6.579273109626237215e+01 7.895148659788326029e+01 7.895148659788326029e+01 8.725543004915714107e+01 8.725543004915714107e+01 7.895148659788326029e+01 9.439061252242548505e+01 9.439061252242548505e+01 9.439061252242548505e+01 9.439061252242548505e+01 9.439061252242548505e+01 7.638502023222400794e+01 5.007174971009894904e+01 2.877089183510568304e+01 2.349588633926480696e+01 1.104382331610272239e+01 1.183554933884102489e+01
2.393878494218512998e+01 3.971400771320994494e+01 6.403264164228588129e+01 8.473706218398866952e+01 9.693757081034097212e+01 1.132497279539650208e+02 1.132497279539650208e+02 1.132497279539650208e+02 1.132497279539650208e+02 1.132497279539650208e+02 1.207001115812032452e+02 1.283625429381374659e+02 1.199650462634487127e+02 1.148456272521866595e+02 9.336487382946074831e+01 6.690401202667050029e+01 3.524179634635719793e+01 2.349588633926480696e+01 1.268114765124931154e+01 1.183554933884102489e+01
2.534931008492736382e+01 4.576323498940008960e+01 6.769048670333923212e+01 9.086931719670849361e+01 1.109814849764023705e+02 1.227520173024205974e+02 1.283625429381374659e+02 1.283625429381374659e+02 1.283625429381374659e+02 1.283625429381374659e+02 1.283625429381374659e+02 1.283625429381374659e+02 1.283625429381374659e+02 1.283625429381374659e+02 1.043334663518753871e+02 7.886063684387423223e+01 5.007174971009894904e+01 2.273445031699447583e+01 1.268114765124931154e+01 1.183554933884102489e+01
2.633666521568449070e+01 4.881672705296045933e+01 6.175534174709036961e+01 8.118491856190294698e+01 9.400126057872785168e+01 1.076779119986649960e+02 1.076779119986649960e+02 1.076779119986649960e+02 1.076779119986649960e+02 1.076779119986649960e+02 1.076779119986649960e+02 1.171375569600467230e+02 1.283625429381374659e+02 1.283625429381374659e+02 1.181755359260947813e+02 8.684720867187627391e+01 5.007174971009894904e+01 2.928880362821520933e+01 1.268114765124931154e+01 1.183554933884102489e+01
1.869530304393056497e+01 3.339411102986181845e+01 4.881672705296045933e+01 6.134281452454425931e+01 7.567539521529837998e+01 8.219033613274473282e+01 8.219033613274473282e+01 8.219033613274473282e+01 8.219033613274473282e+01 7.530281788621522310e+01 8.118491856190294698e+01 9.400126057872785168e+01 1.100620843613411637e+02 1.227520173024205974e+02 1.181755359260947813e+02 9.359152908523493863e+01 6.039662771986459688e+01 2.835345671889059105e+01 1.268114765124931154e+01 1.183554933884102489e+01
1.339636775762456899e+01 2.672737155099598994e+01 2.672737155099598994e+01 3.661064988801934561e+01 4.087182342496812737e+01 4.087182342496812737e+01 5.110163511899187938e+01 5.053738753611506240e+01 4.087182342496812737e+01 4.087182342496812737e+01 4.881672705296045933e+01 7.992423938359198132e+01 9.764740920362447696e+01 1.227520173024205974e+02 1.091137631599018789e+02 9.359152908523493863e+01 5.185884313904862353e+01 3.316530960058688038e+01 1.386576521394682437e+01 1.183554933884102489e+01
1.104382331610272239e+01 1.339636775762456899e+01 1.339636775762456899e+01 2.633666521568449070e+01 2.672737155099598994e+01 2.972823253034478697e+01 2.553695088477722663e+01 2.553695088477722663e+01 2.553695088477722663e+01 2.633666521568449070e+01 4.881672705296045933e+01 6.175534174709036961e+01 1.004521970778825306e+02 1.171375569600467230e+02 1.081478833497694154e+02 9.193040739172322162e+01 5.185884313904862353e+01 2.835345671889059105e+01 1.268114765124931154e+01 1.183554933884102489e+01
1.183554933884102489e+01 1.104382331610272239e+01 1.339636775762456899e+01 1.339636775762456899e+01 1.339636775762456899e+01 1.339636775762456899e+01 1.339636775762456899e+01 1.339636775762456899e+01 1.869530304393056497e+01 2.859782200018512910e+01 4.576323498940008960e+01 7.721115383985404890e+01 1.065077890595537724e+02 1.171375569600467230e+02 1.040631632603014793e+02 7.710806259024825238e+01 5.185884313904862353e+01 2.527755606566381985e+01 1.268114765124931154e+01 1.183554933884102489e+01
1.183554933884102489e+01 1.183554933884102489e+01 1.183554933884102489e+01 1.183554933884102489e+01 1.183554933884102489e+01 1.183554933884102489e+01 1.183554933884102489e+01 1.230322328889600669e+01 1.635522056241975619e+01 2.956499495203489047e+01 5.395828185218518769e+01 8.397629004977790146e+01 1.070499360405912199e+02 1.162579600021027915e+02 9.749817013186441272e+01 6.781148283846803793e+01 3.886163885800823437e+01 2.319488101527312907e+01 1.268114765124931154e+01 1.183554933884102489e+01
1.183554933884102489e+01 1.183554933884102489e+01 1.183554933884102489e+01 1.183554933884102489e+01 1.183554933884102489e+01 1.183554933884102489e+01 1.183554933884102489e+01 1.230322328889600669e+01 2.393878494218512998e+01 3.734713248572933253e+01 6.403264164228588129e+01 9.478336821234398712e+01 1.122855442202182985e+02 1.081478833497694154e+02 9.193040739172322162e+01 5.898366218479067413e+01 3.432091669416706736e+01 1.386576521394682437e+01 1.183554933884102489e+01 1.183554933884102489e+01
1.183554933884102489e+01 1.183554933884102489e+01 1.183554933884102489e+01 1.183554933884102489e+01 1.183554933884102489e+01 1.183554933884102489e+01 1.230322328889600669e+01 1.635522056241975619e+01 2.956499495203489047e+01 5.395828185218518769e+01 8.193251092668245406e+01 1.065077890595537724e+02 1.146508291030773137e+02 1.040631632603014793e+02 7.710806259024825238e+01 5.185884313904862353e+01 2.527755606566381985e+01 1.386576521394682437e+01 1.183554933884102489e+01 1.183554933884102489e+01
1.183554933884102489e+01 1.183554933884102489e+01 1.183554933884102489e+01 1.183554933884102489e+01 1.183554933884102489e+01 1.183554933884102489e+01 1.230322328889600669e+01 2.393878494218512998e+01 3.734713248572933253e+01 6.565236913167660759e+01 9.157916572318288218e+01 1.122855442202182985e+02 1.091137631599018789e+02 9.193040739172322162e+01 6.781148283846803793e+01 3.917779763357049205e+01 2.319488101527312907e+01 1.268114765124931154e+01 1.183554933884102489e+01 1.183554933884102489e+01
1.183554933884102489e+01 1.183554933884102489e+01 1.183554933884102489e+01 1.183554933884102489e+01 1.183554933884102489e+01 1.230322328889600669e+01 1.635522056241975619e+01 2.956499495203489047e+01 4.946452828805954027e+01 7.721115383985404890e+01 1.065077890595537724e+02 1.146508291030773137e+02 1.040631632603014793e+02 7.710806259024825238e+01 5.185884313904862353e+01 3.077029106315971418e+01 1.386576521394682437e+01 1.183554933884102489e+01 1.183554933884102489e+01 1.183554933884102489e+01
1.183554933884102489e+01 1.183554933884102489e+01 1.183554933884102489e+01 1.183554933884102489e+01 1.183554933884102489e+01 1.230322328889600669e+01 2.228844212761229926e+01 3.734713248572933253e+01 6.403264164228588129e+01 9.157916572318288218e+01 1.122855442202182985e+02 1.091137631599018789e+02 9.193040739172322162e+01 6.781148283846803793e+01 3.917779763357049205e+01 2.319488101527312907e+01 1.268114765124931154e+01 1.183554933884102489e+01 1.183554933884102489e+01 1.183554933884102489e+01
1.183554933884102489e+01 1.183554933884102489e+01 1.183554933884102489e+01 1.183554933884102489e+01 1.183554933884102489e+01 1.298392674218082199e+01 2.393878494218512998e+01 4.068040303065372854e+01 7.721115383985404890e+01 1.065077890595537724e+02 1.146508291030773137e+02 1.081478833497694154e+02 8.461010262780149560e+01 5.185884313904862353e+01 3.432091669416706736e+01 1.386576521394682437e+01 1.183554933884102489e+01 1.183554933884102489e+01 1.183554933884102489e+01 1.183554933884102489e+01
1.183554933884102489e+01 1.183554933884102489e+01 1.183554933884102489e+01 1.183554933884102489e+01 1.183554933884102489e+01 1.298392674218082199e+01 2.534931008492736382e+01 5.395828185218518769e+01 8.397629004977790146e+01 1.065077890595537724e+02 1.181755359260947813e+02 1.040631632603014793e+02 7.710806259024825238e+01 5.185884313904862353e+01 2.527755606566381985e+01 1.268114765124931154e+01 1.183554933884102489e+01 1.183554933884102489e+01 1.183554933884102489e+01 1.183554933884102489e+01
1.183554933884102489e+01 1.183554933884102489e+01 1.183554933884102489e+01 1.183554933884102489e+01 1.183554933884102489e+01 1.298392674218082199e+01 2.823618022385453230e+01 5.599621496461711700e+01 8.397629004977790146e+01 1.100620843613411637e+02 1.162579600021027915e+02 9.666178761868705749e+01 6.781148283846803793e+01 3.768722565313707662e+01 2.319488101527312907e+01 1.268114765124931154e+01 1.183554933884102489e+01 1.183554933884102489e+01 1.183554933884102489e+01 1.183554933884102489e+01
