1.879267518775192514e+01 1.879267518775192514e+01 1.879267518775192514e+01 2.798991851775382145e+01 3.608081642969315794e+01 4.606531209108331382e+01 5.950826514525627431e+01 6.682260102448270800e+01 6.632171078727559177e+01 5.329489503960851948e+01 4.339084520137006251e+01 3.089469782731420366e+01
1.879267518775192514e+01 1.879267518775192514e+01 1.879267518775192514e+01 2.798991851775382145e+01 3.818157913260169067e+01 4.889760240019449355e+01 6.446372933080759537e+01 6.609502403914319757e+01 6.484112760149326959e+01 5.329489503960851948e+01 3.977607990470268362e+01 2.736132129224881382e+01
1.879267518775192514e+01 1.879267518775192514e+01 1.879267518775192514e+01 2.798991851775382145e+01 3.818157913260169067e+01 4.889760240019449355e+01 6.446372933080759537e+01 6.828596912023709820e+01 6.484112760149326959e+01 5.217364152756513818e+01 3.641709962658419641e+01 2.397780519733225191e+01
1.879267518775192514e+01 1.879267518775192514e+01 2.627369610294725533e+01 2.798991851775382145e+01 4.445615562070146609e+01 5.950826514525627431e+01 6.446372933080759537e+01 6.828596912023709820e+01 6.165477186222090467e+01 4.829067236709413891e+01 3.669963866136973252e+01 2.397780519733225191e+01
1.879267518775192514e+01 1.879267518775192514e+01 2.798991851775382145e+01 3.608081642969315794e+01 4.606531209108331382e+01 5.950826514525627431e+01 6.682260102448270800e+01 6.632171078727559177e+01 5.705708051850069751e+01 4.339084520137006251e+01 3.669963866136973252e+01 1.879267518775192514e+01
1.879267518775192514e+01 1.879267518775192514e+01 2.798991851775382145e+01 3.818157913260169067e+01 4.889760240019449355e+01 5.950826514525627431e+01 6.682260102448270800e+01 6.484112760149326959e+01 5.560597087215310808e+01 3.977607990470268362e+01 2.736132129224881382e+01 1.879267518775192514e+01
1.879267518775192514e+01 1.879267518775192514e+01 2.798991851775382145e+01 3.818157913260169067e+01 4.889760240019449355e+01 6.446372933080759537e+01 6.828596912023709820e+01 6.484112760149326959e+01 4.829067236709413891e+01 3.641709962658419641e+01 2.736132129224881382e+01 1.879267518775192514e+01
1.879267518775192514e+01 1.879267518775192514e+01 2.798991851775382145e+01 3.818157913260169067e+01 5.292631807554234769e+01 6.446372933080759537e+01 6.828596912023709820e+01 6.484112760149326959e+01 4.829067236709413891e+01 3.641709962658419641e+01 2.397780519733225191e+01 1.879267518775192514e+01
1.879267518775192514e+01 1.879267518775192514e+01 2.798991851775382145e+01 4.445615562070146609e+01 5.950826514525627431e+01 6.682260102448270800e+01 6.632171078727559177e+01 5.560597087215310808e+01 4.611884492092629984e+01 3.669963866136973252e+01 1.879267518775192514e+01 1.879267518775192514e+01
1.879267518775192514e+01 2.627369610294725533e+01 3.608081642969315794e+01 4.889760240019449355e+01 5.950826514525627431e+01 6.682260102448270800e+01 6.632171078727559177e+01 5.705708051850069751e+01 4.339084520137006251e+01 2.736132129224881382e+01 1.879267518775192514e+01 1.879267518775192514e+01
1.879267518775192514e+01 2.798991851775382145e+01 3.608081642969315794e+01 4.889760240019449355e+01 6.446372933080759537e+01 6.828596912023709820e+01 6.632171078727559177e+01 5.329489503960851948e+01 3.977607990470268362e+01 2.736132129224881382e+01 1.879267518775192514e+01 1.879267518775192514e+01
1.879267518775192514e+01 2.798991851775382145e+01 3.818157913260169067e+01 4.889760240019449355e+01 6.446372933080759537e+01 6.828596912023709820e+01 6.484112760149326959e+01 5.285743851031870832e+01 3.977607990470268362e+01 2.736132129224881382e+01 1.879267518775192514e+01 1.879267518775192514e+01
