1.158110363394613529e+01 1.158110363394613529e+01 1.558742555437012811e+01 1.903280466541154681e+01 2.447301610783419790e+01 3.251562871492648554e+01 4.336480398879415787e+01 5.525595712914040547e+01 6.308158309388560525e+01 6.267230349705395298e+01 5.370818412443058776e+01 4.285906983146652038e+01
1.158110363394613529e+01 1.158110363394613529e+01 1.558742555437012811e+01 1.903280466541154681e+01 2.845520248656032436e+01 4.006161956688875136e+01 4.939720500111564405e+01 6.351984677961057457e+01 6.565804160153898295e+01 6.171258800103296949e+01 5.299124668960420337e+01 4.026375897011257621e+01
1.158110363394613529e+01 1.558742555437012811e+01 1.903280466541154681e+01 2.568642932950634972e+01 3.481033608750682617e+01 4.565952359986687981e+01 5.902299411483339497e+01 6.508886187900550624e+01 6.758533014372969205e+01 6.105602684236009736e+01 4.974467524754464165e+01 3.730057418166283156e+01
1.158110363394613529e+01 1.558742555437012811e+01 1.903280466541154681e+01 3.068805729002670191e+01 4.336480398879415787e+01 5.568847716068111708e+01 6.446286518612856753e+01 6.802242169097067404e+01 6.599140667477071531e+01 5.489435175816205259e+01 4.309491318411292582e+01 3.650045395444479368e+01
1.558742555437012811e+01 1.903280466541154681e+01 2.568642932950634972e+01 3.481033608750682617e+01 4.805842715692001121e+01 5.902299411483339497e+01 6.727541839154129377e+01 6.782147219073812039e+01 6.105602684236009736e+01 4.974467524754464165e+01 4.026375897011257621e+01 2.741131427723970404e+01
1.558742555437012811e+01 1.903280466541154681e+01 3.068805729002670191e+01 4.006161956688875136e+01 5.568847716068111708e+01 6.446286518612856753e+01 6.802242169097067404e+01 6.599140667477071531e+01 5.489435175816205259e+01 4.542253298787926497e+01 3.650045395444479368e+01 2.384408542795988240e+01
1.903280466541154681e+01 2.447301610783419790e+01 3.481033608750682617e+01 4.565952359986687981e+01 5.902299411483339497e+01 6.727541839154129377e+01 6.782147219073812039e+01 6.105602684236009736e+01 4.974467524754464165e+01 3.924132468695639631e+01 2.741131427723970404e+01 2.434261648714289805e+01
2.447301610783419790e+01 3.068805729002670191e+01 4.006161956688875136e+01 5.353806537784159048e+01 6.446286518612856753e+01 6.802242169097067404e+01 6.599140667477071531e+01 5.489435175816205259e+01 4.309491318411292582e+01 3.514014602696539669e+01 2.384408542795988240e+01 1.779124732384464735e+01
2.568642932950634972e+01 3.481033608750682617e+01 4.565952359986687981e+01 5.902299411483339497e+01 6.676633377491636168e+01 6.782147219073812039e+01 6.105602684236009736e+01 4.974467524754464165e+01 3.730057418166283156e+01 2.741131427723970404e+01 1.779124732384464735e+01 1.558742555437012811e+01
3.068805729002670191e+01 4.006161956688875136e+01 5.353806537784159048e+01 6.446286518612856753e+01 6.768133994164480782e+01 6.599140667477071531e+01 5.489435175816205259e+01 4.309491318411292582e+01 3.038453429062137090e+01 2.384408542795988240e+01 1.779124732384464735e+01 1.158110363394613529e+01
3.481033608750682617e+01 4.600043852459117488e+01 5.902299411483339497e+01 6.676633377491636168e+01 6.782147219073812039e+01 6.105602684236009736e+01 4.974467524754464165e+01 3.924132468695639631e+01 2.741131427723970404e+01 2.434261648714289805e+01 1.558742555437012811e+01 1.158110363394613529e+01
4.287901470896627387e+01 5.568847716068111708e+01 6.440310660185696179e+01 6.782147219073812039e+01 6.365698318780290776e+01 5.342147814389404203e+01 4.309491318411292582e+01 2.833768747879096850e+01 2.434261648714289805e+01 1.779124732384464735e+01 1.158110363394613529e+01 1.158110363394613529e+01
