1.559207465799529047e+01 2.362518554453763642e+01 2.362518554453763642e+01 3.110199311514046983e+01 3.410809905647987250e+01 4.144166475204661282e+01 4.995541823715537078e+01 6.379445248270306479e+01 6.849416796038754285e+01 7.291419872668589619e+01 7.011531308249419681e+01 6.011441253073452629e+01
1.559207465799529047e+01 1.903280466541154681e+01 2.362518554453763642e+01 2.765364751566780299e+01 3.232508044613778253e+01 3.939084409021739930e+01 5.151880657046694978e+01 5.953243000770646631e+01 6.849416796038754285e+01 7.253389545715880615e+01 7.011531308249419681e+01 6.011441253073452629e+01
1.559207465799529047e+01 1.559207465799529047e+01 1.903280466541154681e+01 2.629951537730824995e+01 3.425867868223639334e+01 4.565952359986687981e+01 5.568847716068111708e+01 6.719251848877604516e+01 7.482826328695676921e+01 7.530738033919406860e+01 7.104005079584885607e+01 5.508816207879548443e+01
1.193856458962763512e+01 1.559207465799529047e+01 1.903280466541154681e+01 2.845520248656032436e+01 3.861161057915205674e+01 4.939720500111564405e+01 6.345487373559569733e+01 7.482826328695676921e+01 7.989502810985368342e+01 7.499151470557747245e+01 6.578970942715562842e+01 5.394601051001173175e+01
1.193856458962763512e+01 1.559207465799529047e+01 1.903280466541154681e+01 2.845520248656032436e+01 4.287901470896627387e+01 5.429199599280440935e+01 6.719251848877604516e+01 7.929749168285513861e+01 8.322795464219029782e+01 8.129415529268925411e+01 6.712424775122084952e+01 5.284887794812052420e+01
1.559207465799529047e+01 1.559207465799529047e+01 2.447301610783419790e+01 3.188432324608385926e+01 4.287901470896627387e+01 5.429199599280440935e+01 7.190945392347526877e+01 8.070309043677229965e+01 8.587147801727606122e+01 8.129415529268925411e+01 6.712424775122084952e+01 5.284887794812052420e+01
1.559207465799529047e+01 1.903280466541154681e+01 2.378751053199546206e+01 3.188432324608385926e+01 4.144166475204661282e+01 5.334756912208908375e+01 6.703084026210852642e+01 7.766896643119623889e+01 8.468914326347200472e+01 7.974602681800303117e+01 6.936951344301117217e+01 5.159513445297108802e+01
1.923070796469467325e+01 2.378751053199546206e+01 2.872885464898533669e+01 3.232508044613778253e+01 4.031241918773960720e+01 5.364126482988330480e+01 6.416120086343151740e+01 7.312864509607479135e+01 8.055438716824889411e+01 7.974602681800303117e+01 6.936951344301117217e+01 5.159513445297108802e+01
2.568642932950634972e+01 2.978218144911477339e+01 3.560850551798530006e+01 3.896910906010626263e+01 4.468465189184406228e+01 5.525595712914040547e+01 6.379445248270306479e+01 7.190945392347526877e+01 7.766896643119623889e+01 7.974602681800303117e+01 6.936951344301117217e+01 6.011441253073452629e+01
3.481033608750682617e+01 3.964906110808343698e+01 4.431392740151844123e+01 5.034418940275534027e+01 5.494259125121025988e+01 5.770890268865769457e+01 6.404807063835623637e+01 6.849416796038754285e+01 7.714570069952081610e+01 7.428373163779131971e+01 6.936951344301117217e+01 5.394601051001173175e+01
4.431392740151844123e+01 5.138108310463894668e+01 6.351984677961057457e+01 6.613900328506514370e+01 6.613900328506514370e+01 6.613900328506514370e+01 7.140535079234474836e+01 7.219201538537113549e+01 7.801352099204632395e+01 7.337995740588101512e+01 6.604795708957084344e+01 5.508816207879548443e+01
5.138108310463894668e+01 6.345487373559569733e+01 7.380270671017544259e+01 7.989502810985368342e+01 8.358614718255192599e+01 8.032110749804030547e+01 7.677998442030941817e+01 7.530738033919406860e+01 7.428373163779131971e+01 7.063322577138285396e+01 6.105602684236009736e+01 4.802167056231006370e+01
