1.111111144224802699e-01 1.111111144224802699e-01 1.111111144224802699e-01 1.111111144224802699e-01 1.111111144224802699e-01 1.111111144224802699e-01 0.000000000000000000e+00 0.000000000000000000e+00 1.111111144224802699e-01 1.111111144224802699e-01 1.111111164093017578e+00 7.777777810891469690e-01 7.833333373069763184e+00 9.629629850387574352e-01 7.777777810891469690e-01 7.777777810891469690e-01 9.629629850387574352e-01 4.355555633703867890e+00 4.333333349227904918e+00 1.511111112435658832e+01 1.111111144224802699e-01 6.541666790843009949e+00 1.111111144224802699e-01 0.000000000000000000e+00 1.111111144224802699e-01 1.111111144224802699e-01
1.111111144224802699e-01 1.111111144224802699e-01 1.111111144224802699e-01 1.111111144224802699e-01 1.111111144224802699e-01 1.111111144224802699e-01 0.000000000000000000e+00 1.111111144224802699e-01 5.333333333333333037e+00 0.000000000000000000e+00 1.111111144224802699e-01 1.111111144224802699e-01 1.111111144224802699e-01 5.666666828095912933e+00 1.111111164093017578e+00 1.233333396911621094e+01 5.555555820465087891e+00 2.555555591980616104e+00 6.444444497426350615e+00 1.186666674613952566e+01 2.111111223697662354e+00 2.000000119209289551e+00 4.761904988970075081e+00 1.111111144224802699e-01 1.111111144224802699e-01 1.111111144224802699e-01
1.111111144224802699e-01 1.111111144224802699e-01 1.111111144224802699e-01 1.111111144224802699e-01 1.111111144224802699e-01 1.111111144224802699e-01 0.000000000000000000e+00 1.111111144224802699e-01 1.111111144224802699e-01 1.111111144224802699e-01 7.777777810891469690e-01 1.186666674613952566e+01 1.555555608537461998e+00 1.111111154158910042e+00 4.333333349227904918e+00 1.222222288449605232e+00 1.000000029802322388e+00 3.666666686534881592e+00 3.285714302744184412e+00 6.066666793823242188e+01 6.666667064030965539e-01 1.511111112435658832e+01 1.111111144224802699e-01 1.111111144224802699e-01 1.111111144224802699e-01 1.111111144224802699e-01
1.111111144224802699e-01 1.111111144224802699e-01 1.111111144224802699e-01 1.111111144224802699e-01 1.111111144224802699e-01 1.111111144224802699e-01 1.111111144224802699e-01 1.666666775941848755e+00 4.888888915379841493e-01 1.111111144224802699e-01 1.111111144224802699e-01 1.111111144224802699e-01 1.111111144224802699e-01 5.555555820465087891e+00 4.066666793823242188e+01 5.333333333333333037e+00 5.666666712079729606e+00 2.888889018694559940e+00 4.333333349227904918e+00 4.333333349227904918e+00 4.761904988970075081e+00 1.008333348482847214e+01 1.111111144224802699e-01 1.000000029802322388e+00 1.111111144224802699e-01 1.111111144224802699e-01
1.111111144224802699e-01 1.111111144224802699e-01 1.111111144224802699e-01 1.111111144224802699e-01 1.111111144224802699e-01 1.111111144224802699e-01 0.000000000000000000e+00 7.777777810891469690e-01 1.688888955116272017e+00 6.444444497426350615e+00 4.333333349227904918e+00 1.166666696468989128e+00 5.333333468437194824e+01 9.629629850387574352e-01 7.777777810891469690e-01 1.388888915379842048e+00 2.100000047683715820e+01 4.333333349227904918e+00 4.761904988970075081e+00 1.588888976971308331e+01 1.040740762154261390e+01 9.444444626569747925e-01 1.111111144224802699e-01 0.000000000000000000e+00 1.111111144224802699e-01 1.111111144224802699e-01
1.111111144224802699e-01 1.111111144224802699e-01 1.111111144224802699e-01 1.111111144224802699e-01 1.111111144224802699e-01 1.111111144224802699e-01 0.000000000000000000e+00 1.111111144224802699e-01 7.777777810891469690e-01 3.285714302744184412e+00 1.555555608537461998e+00 1.111111144224802699e-01 1.111111144224802699e-01 1.688888955116272017e+00 4.333333349227904918e+00 4.761904988970075081e+00 3.977777862548828125e+01 5.333333468437194824e+01 1.326666666666666572e+02 6.444444497426350615e+00 5.000000059604644775e+00 6.444444497426350615e+00 1.111111144224802699e-01 2.666666666666666519e+00 1.111111144224802699e-01 1.111111144224802699e-01
1.111111144224802699e-01 1.111111144224802699e-01 1.111111144224802699e-01 1.111111144224802699e-01 1.111111144224802699e-01 1.111111144224802699e-01 0.000000000000000000e+00 3.285714302744184412e+00 5.400000085433324770e+00 9.199999999999999289e+00 2.148148225413428758e+00 4.761904988970075081e+00 2.116666683554649353e+01 2.100000000000000000e+01 5.400000000000000000e+01 2.066666793823242188e+01 6.066666793823242188e+01 5.555555820465087891e+00 1.333333373069763184e+00 5.666666712079729606e+00 1.111111144224802699e-01 1.000000029802322388e+00 1.111111144224802699e-01 1.111111144224802699e-01 1.111111144224802699e-01 1.111111144224802699e-01
1.111111144224802699e-01 1.111111144224802699e-01 1.111111144224802699e-01 1.111111144224802699e-01 1.111111144224802699e-01 1.111111144224802699e-01 0.000000000000000000e+00 9.714285944189343880e+00 1.333333366447024826e+00 4.055555716156959534e+00 4.333333349227904918e+00 4.244444529215494555e+01 4.466666793823242188e+01 2.077777868509292603e+01 5.333333333333333037e+00 2.506666749715805054e+01 5.555555820465087891e+00 2.883333396911621094e+01 6.444444497426350615e+00 3.200000139077504357e+00 2.555555621782938491e+00 2.416666828095912933e+00 2.555555621782938491e+00 1.111111144224802699e-01 1.111111144224802699e-01 1.111111144224802699e-01
1.111111144224802699e-01 1.111111144224802699e-01 1.111111144224802699e-01 1.111111144224802699e-01 1.111111144224802699e-01 1.111111144224802699e-01 0.000000000000000000e+00 4.111111239592234057e+01 3.533333587646484375e+01 9.476190618106297592e+00 3.116666698455810547e+01 1.326666666666666572e+02 5.333333468437194824e+01 1.950000129640102386e+01 1.966666734218597412e+01 1.800000000000000000e+01 7.333333492279052734e+00 5.555555820465087891e+00 3.285714302744184412e+00 1.000000029802322388e+00 1.111111144224802699e-01 7.777777810891469690e-01 1.111111144224802699e-01 1.111111144224802699e-01 1.111111144224802699e-01 1.111111144224802699e-01
1.111111144224802699e-01 1.111111144224802699e-01 1.111111144224802699e-01 1.111111144224802699e-01 1.111111144224802699e-01 1.111111144224802699e-01 0.000000000000000000e+00 1.186666674613952566e+01 1.111111144224802699e-01 1.111111144224802699e-01 4.888888915379841493e-01 2.555555591980616104e+00 1.326666666666666572e+02 4.466666793823242188e+01 4.333333349227904918e+00 5.000000000000000000e+01 3.285714302744184412e+00 3.285714302744184412e+00 5.555555820465087891e+00 2.555555621782938491e+00 2.074074149131774902e+00 1.111111144224802699e-01 5.166666671633720398e+00 0.000000000000000000e+00 1.111111144224802699e-01 1.111111144224802699e-01
1.111111144224802699e-01 1.111111144224802699e-01 1.111111144224802699e-01 1.111111144224802699e-01 1.111111144224802699e-01 1.111111144224802699e-01 0.000000000000000000e+00 5.555555820465087891e+00 5.333333333333333037e+00 5.333333333333333037e+00 1.022222227851549725e+01 1.911111195882161340e+01 9.629629850387574352e-01 4.333333349227904918e+00 5.400000000000000000e+01 1.569629660712348027e+02 1.186666674613952566e+01 2.916666731238365173e+01 3.285714302744184412e+00 2.933333462476730347e+01 2.555555621782938491e+00 1.333333373069763184e+00 1.111111144224802699e-01 0.000000000000000000e+00 1.111111144224802699e-01 1.111111144224802699e-01
1.111111144224802699e-01 1.111111144224802699e-01 1.111111144224802699e-01 1.111111144224802699e-01 1.111111144224802699e-01 1.111111144224802699e-01 0.000000000000000000e+00 1.111111144224802699e-01 2.000000119209289551e+00 1.111111144224802699e-01 7.777777810891469690e-01 1.000000064074993134e+01 4.333333349227904918e+00 5.555555820465087891e+00 2.077777868509292603e+01 2.555555591980616104e+00 5.333333333333333037e+00 1.606666776537895203e+01 2.111111223697662354e+00 2.148148225413428758e+00 7.000000089406966941e-01 1.111111144224802699e-01 1.111111144224802699e-01 1.111111144224802699e-01 1.111111144224802699e-01 1.111111144224802699e-01
1.111111144224802699e-01 1.111111144224802699e-01 1.111111144224802699e-01 1.111111144224802699e-01 1.111111144224802699e-01 1.111111144224802699e-01 4.888888915379841493e-01 1.222222288449605232e+00 4.888888915379841826e+00 4.055555716156959534e+00 1.014814846383200830e+01 1.777777822812398156e+01 1.888888937234878540e+01 2.933333462476730347e+01 1.111111144224802699e-01 2.555555591980616104e+00 5.333333333333333037e+00 2.888888899485270301e+01 6.444444497426350615e+00 1.111111164093017578e+00 1.186666674613952566e+01 1.111111144224802699e-01 1.111111144224802699e-01 0.000000000000000000e+00 1.111111144224802699e-01 1.111111144224802699e-01
1.111111144224802699e-01 1.111111144224802699e-01 1.111111144224802699e-01 1.111111144224802699e-01 1.111111144224802699e-01 1.111111144224802699e-01 0.000000000000000000e+00 6.444444497426350615e+00 7.777777810891469690e-01 6.533333563804626820e+00 9.703703757789400086e+00 1.911111195882161340e+01 6.444444497426350615e+00 1.111111144224802699e-01 3.688888974984487135e+01 2.555555591980616104e+00 5.333333333333333037e+00 2.666666734218597412e+01 3.285714302744184412e+00 1.166666696468989128e+00 1.055555572112401252e+00 9.629629850387574352e-01 1.111111144224802699e-01 0.000000000000000000e+00 1.111111144224802699e-01 1.111111144224802699e-01
0.000000000000000000e+00 1.111111144224802699e-01 0.000000000000000000e+00 5.555555820465087891e+00 0.000000000000000000e+00 5.333333333333333037e+00 1.555555611848831177e+00 1.111111154158910042e+00 1.833333387970924377e+00 1.111111144224802699e-01 1.333333373069763184e+00 2.888888899485270301e+01 3.285714302744184412e+00 1.111111144224802699e-01 6.444444497426350615e+00 9.629629850387574352e-01 3.222222328186035156e+00 3.533333587646484375e+01 3.200000139077504357e+00 4.888888915379841493e-01 1.888888945182164436e+00 1.111111144224802699e-01 1.111111144224802699e-01 0.000000000000000000e+00 1.111111144224802699e-01 1.111111144224802699e-01
1.111111144224802699e-01 1.111111164093017578e+00 9.199999999999999289e+00 1.111111144224802699e-01 1.111111144224802699e-01 1.111111144224802699e-01 1.111111144224802699e-01 1.222222288449605232e+00 2.148148225413428758e+00 5.555555820465087891e+00 2.244444531202316462e+00 1.111111164093017578e+00 9.629629850387574352e-01 1.111111144224802699e-01 1.111111144224802699e-01 1.611111164093017578e+00 4.333333349227904918e+00 5.555555820465087891e+00 6.444444497426350615e+00 5.333333333333333037e+00 2.666666666666666519e+00 1.111111144224802699e-01 1.000000029802322388e+00 0.000000000000000000e+00 1.111111144224802699e-01 1.111111144224802699e-01
6.666667064030965539e-01 1.407407482465108162e+00 1.111111144224802699e-01 9.629629850387574352e-01 1.666666775941848755e+00 4.761904988970075081e+00 1.388888915379842048e+00 1.037037084499994988e+00 1.222222288449605232e+00 1.111111144224802699e-01 9.444444626569747925e-01 4.888888915379841493e-01 1.444444457689921135e+00 2.555555591980616104e+00 5.333333333333333037e+00 1.333333412806193108e+00 9.199999999999999289e+00 3.285714302744184412e+00 3.285714302744184412e+00 7.777777810891469690e-01 1.688888955116272017e+00 1.962962998284234040e+00 1.111111144224802699e-01 0.000000000000000000e+00 1.111111144224802699e-01 1.111111144224802699e-01
4.333333349227904918e+00 5.333333333333333037e+00 2.555555591980616104e+00 5.333333333333333037e+00 1.666666775941848755e+00 4.761904988970075081e+00 1.407407482465108162e+00 1.629629717932806976e+00 1.777777804268730666e+00 3.777777830759684097e+00 1.166666696468989128e+00 4.055555716156959534e+00 1.000000029802322388e+00 5.555555820465087891e+00 1.111111144224802699e-01 5.333333333333333037e+00 5.083333685994148254e+00 2.111111223697662354e+00 1.111111144224802699e-01 1.111111144224802699e-01 3.777777883741591403e+00 1.111111144224802699e-01 1.111111144224802699e-01 0.000000000000000000e+00 1.111111144224802699e-01 1.111111144224802699e-01
5.555555820465087891e+00 1.666666775941848755e+00 4.761904988970075081e+00 8.000000476837158203e+00 1.511111112435658832e+01 6.500000318884849548e+01 3.022222312291463098e+00 6.444444497426350615e+00 1.388888915379842048e+00 1.111111164093017578e+00 4.888888915379841493e-01 7.777777810891469690e-01 2.111111223697662354e+00 3.285714302744184412e+00 4.761904988970075081e+00 4.066666793823242188e+01 3.925926105843649871e+00 1.055555572112401252e+00 1.407407482465108162e+00 1.055555572112401252e+00 4.333333349227904918e+00 1.166666696468989128e+00 1.111111144224802699e-01 0.000000000000000000e+00 1.111111144224802699e-01 1.111111144224802699e-01
1.666666775941848755e+00 4.761904988970075081e+00 3.444444497426350615e+00 4.761904988970075081e+00 9.476190618106297592e+00 2.400000031789143762e+01 1.186666674613952566e+01 3.285714302744184412e+00 4.735042903667841863e+00 7.714285820722579956e+00 4.055555716156959534e+00 1.407407442728678459e+00 1.111111144224802699e-01 5.666666828095912933e+00 2.888889018694559940e+00 4.761904988970075081e+00 6.066666793823242188e+01 1.111111164093017578e+00 1.111111144224802699e-01 1.111111144224802699e-01 2.244444531202316462e+00 1.111111144224802699e-01 1.111111144224802699e-01 1.111111144224802699e-01 1.111111144224802699e-01 1.111111144224802699e-01
5.083333685994148254e+00 1.733333346247672990e+00 4.761904988970075081e+00 2.506666749715805054e+01 1.373333361148834264e+01 2.506666749715805054e+01 9.199999999999999289e+00 1.569629660712348027e+02 4.133333367109298884e+00 4.761904988970075081e+00 7.777777810891469690e-01 1.186666674613952566e+01 7.666666924953460693e+00 1.373333361148834264e+01 5.555555820465087891e+00 4.466666793823242188e+01 5.333333333333333037e+00 1.444444517294565911e+00 1.555555611848831177e+00 1.833333387970924377e+00 7.777777810891469690e-01 1.111111144224802699e-01 1.111111144224802699e-01 1.111111144224802699e-01 1.111111144224802699e-01 1.111111144224802699e-01
5.166666671633720398e+00 5.333333333333333037e+00 2.222222301695081725e+00 2.555555591980616104e+00 2.577777854601542185e+00 4.244444529215494555e+01 8.363636509938672248e+00 9.600000344713528477e+01 1.465833387374877930e+02 1.200000000000000000e+02 1.200000000000000000e+02 2.100000000000000000e+01 2.027777865529060364e+01 2.400000031789143762e+01 1.511111112435658832e+01 1.888888945182164436e+00 1.111111144224802699e-01 0.000000000000000000e+00 1.111111144224802699e-01 2.555555591980616104e+00 2.577777854601542185e+00 4.761904988970075081e+00 1.000000029802322388e+00 1.111111144224802699e-01 1.111111144224802699e-01 1.111111144224802699e-01
1.111111144224802699e-01 1.111111144224802699e-01 1.111111144224802699e-01 1.111111144224802699e-01 1.186666674613952566e+01 1.111111144224802699e-01 1.111111144224802699e-01 1.111111144224802699e-01 1.111111144224802699e-01 1.111111144224802699e-01 1.111111144224802699e-01 1.111111144224802699e-01 1.111111144224802699e-01 1.111111144224802699e-01 1.111111144224802699e-01 1.111111144224802699e-01 4.055555716156959534e+00 0.000000000000000000e+00 1.111111144224802699e-01 1.111111144224802699e-01 1.111111144224802699e-01 1.111111144224802699e-01 0.000000000000000000e+00 1.111111144224802699e-01 1.111111144224802699e-01 1.111111144224802699e-01
0.000000000000000000e+00 0.000000000000000000e+00 0.000000000000000000e+00 0.000000000000000000e+00 0.000000000000000000e+00 1.111111144224802699e-01 1.111111144224802699e-01 4.200000000000000000e+01 1.111111144224802699e-01 1.111111144224802699e-01 1.111111144224802699e-01 1.111111144224802699e-01 1.111111144224802699e-01 1.111111144224802699e-01 1.373333361148834264e+01 0.000000000000000000e+00 1.333333373069763184e+00 0.000000000000000000e+00 0.000000000000000000e+00 0.000000000000000000e+00 1.111111144224802699e-01 0.000000000000000000e+00 0.000000000000000000e+00 1.111111144224802699e-01 1.111111144224802699e-01 1.111111144224802699e-01
1.111111144224802699e-01 1.111111144224802699e-01 1.111111144224802699e-01 1.111111144224802699e-01 1.111111144224802699e-01 1.111111144224802699e-01 1.111111144224802699e-01 1.111111144224802699e-01 1.111111144224802699e-01 1.111111144224802699e-01 1.111111144224802699e-01 1.111111144224802699e-01 1.111111144224802699e-01 1.111111144224802699e-01 1.111111144224802699e-01 1.111111144224802699e-01 1.111111144224802699e-01 1.111111144224802699e-01 1.111111144224802699e-01 1.111111144224802699e-01 1.111111144224802699e-01 1.111111144224802699e-01 1.111111144224802699e-01 1.111111144224802699e-01 1.111111144224802699e-01 1.111111144224802699e-01
1.111111144224802699e-01 1.111111144224802699e-01 1.111111144224802699e-01 1.111111144224802699e-01 1.111111144224802699e-01 1.111111144224802699e-01 1.111111144224802699e-01 1.111111144224802699e-01 1.111111144224802699e-01 1.111111144224802699e-01 1.111111144224802699e-01 1.111111144224802699e-01 1.111111144224802699e-01 1.111111144224802699e-01 1.111111144224802699e-01 1.111111144224802699e-01 1.111111144224802699e-01 1.111111144224802699e-01 1.111111144224802699e-01 1.111111144224802699e-01 1.111111144224802699e-01 1.111111144224802699e-01 1.111111144224802699e-01 1.111111144224802699e-01 1.111111144224802699e-01 1.111111144224802699e-01
