1.647222304344177246e+01 1.647222304344177246e+01 1.647222304344177246e+01 1.647222304344177246e+01 1.647222304344177246e+01 1.647222304344177246e+01 1.647222304344177246e+01 1.647222304344177246e+01 1.647222304344177246e+01 1.647222304344177246e+01 1.647222304344177246e+01 1.647222304344177246e+01 1.647222304344177246e+01 1.754444498221079485e+01 1.754444498221079485e+01 1.954166692495346069e+01 1.993650883720034628e+01 1.993650883720034628e+01 1.903333438237508091e+01 1.924074125289916992e+01 2.094583426713943552e+01 1.993650883720034628e+01 2.250000115235646447e+01 2.309333412170410327e+01 2.309333412170410327e+01 2.263888953129450599e+01
1.647222304344177246e+01 1.647222304344177246e+01 1.647222304344177246e+01 1.647222304344177246e+01 1.647222304344177246e+01 1.647222304344177246e+01 1.647222304344177246e+01 1.647222304344177246e+01 1.647222304344177246e+01 1.647222304344177246e+01 1.647222304344177246e+01 1.647222304344177246e+01 1.647222304344177246e+01 1.647222304344177246e+01 1.754444498221079485e+01 1.954166692495346069e+01 1.993650883720034628e+01 1.881333393096923601e+01 1.881333393096923601e+01 1.881333393096923601e+01 2.094583426713943552e+01 1.993650883720034628e+01 2.250000115235646447e+01 2.256666779518127441e+01 2.270833427459001541e+01 2.270833427459001541e+01
1.647222304344177246e+01 1.647222304344177246e+01 1.647222304344177246e+01 1.647222304344177246e+01 1.647222304344177246e+01 1.647222304344177246e+01 1.647222304344177246e+01 1.647222304344177246e+01 1.647222304344177246e+01 1.647222304344177246e+01 1.647222304344177246e+01 1.647222304344177246e+01 1.647222304344177246e+01 1.647222304344177246e+01 1.754444498221079485e+01 1.754444498221079485e+01 1.881333393096923601e+01 1.754444498221079485e+01 1.840277860562006396e+01 1.881333393096923601e+01 2.094583426713943552e+01 1.993650883720034628e+01 2.263888953129450599e+01 2.256666779518127441e+01 2.250000115235646447e+01 2.270833427459001541e+01
1.647222304344177246e+01 1.647222304344177246e+01 1.647222304344177246e+01 1.647222304344177246e+01 1.647222304344177246e+01 1.647222304344177246e+01 1.647222304344177246e+01 1.647222304344177246e+01 1.647222304344177246e+01 1.647222304344177246e+01 1.647222304344177246e+01 1.647222304344177246e+01 1.647222304344177246e+01 1.647222304344177246e+01 1.647222304344177246e+01 1.647222304344177246e+01 1.754444498221079485e+01 1.754444498221079485e+01 1.754444498221079485e+01 1.881333393096923601e+01 2.094583426713943552e+01 1.993650883720034628e+01 2.263888953129450599e+01 2.256666779518127441e+01 2.250000115235646447e+01 2.270833427459001541e+01
1.647222304344177246e+01 1.647222304344177246e+01 1.647222304344177246e+01 1.647222304344177246e+01 1.647222304344177246e+01 1.647222304344177246e+01 1.647222304344177246e+01 1.647222304344177246e+01 1.647222304344177246e+01 1.647222304344177246e+01 1.647222304344177246e+01 1.647222304344177246e+01 1.647222304344177246e+01 1.647222304344177246e+01 1.647222304344177246e+01 1.647222304344177246e+01 1.754444498221079485e+01 1.754444498221079485e+01 1.903333438237508091e+01 1.954166692495346069e+01 2.018750047683715820e+01 1.993650883720034628e+01 2.263888953129450599e+01 2.168750110268592834e+01 2.263888953129450599e+01 2.122222383817037183e+01
1.647222304344177246e+01 1.647222304344177246e+01 1.647222304344177246e+01 1.647222304344177246e+01 1.647222304344177246e+01 1.647222304344177246e+01 1.647222304344177246e+01 1.647222304344177246e+01 1.647222304344177246e+01 1.647222304344177246e+01 1.647222304344177246e+01 1.647222304344177246e+01 1.647222304344177246e+01 1.647222304344177246e+01 1.647222304344177246e+01 1.754444498221079485e+01 1.903333438237508091e+01 1.903333438237508091e+01 1.903333438237508091e+01 1.954166692495346069e+01 2.018750047683715820e+01 1.993650883720034628e+01 2.263888953129450599e+01 2.168750110268592834e+01 2.168750110268592834e+01 2.122222383817037183e+01
1.647222304344177246e+01 1.647222304344177246e+01 1.647222304344177246e+01 1.647222304344177246e+01 1.647222304344177246e+01 1.647222304344177246e+01 1.647222304344177246e+01 1.647222304344177246e+01 1.647222304344177246e+01 1.647222304344177246e+01 1.647222304344177246e+01 1.647222304344177246e+01 1.647222304344177246e+01 1.647222304344177246e+01 1.754444498221079485e+01 1.903333438237508091e+01 1.903333438237508091e+01 1.903333438237508091e+01 1.954166692495346069e+01 1.954166692495346069e+01 2.018750047683715820e+01 1.993650883720034628e+01 2.080000127156575473e+01 2.168750110268592834e+01 2.168750110268592834e+01 2.018750047683715820e+01
1.647222304344177246e+01 1.647222304344177246e+01 1.647222304344177246e+01 1.647222304344177246e+01 1.647222304344177246e+01 1.647222304344177246e+01 1.647222304344177246e+01 1.647222304344177246e+01 1.647222304344177246e+01 1.647222304344177246e+01 1.647222304344177246e+01 1.647222304344177246e+01 1.647222304344177246e+01 1.754444498221079485e+01 1.903333438237508091e+01 1.954166692495346069e+01 1.954166692495346069e+01 1.954166692495346069e+01 1.993650883720034628e+01 1.993650883720034628e+01 2.094583426713943552e+01 2.094583426713943552e+01 2.080000127156575473e+01 2.018750047683715820e+01 2.018750047683715820e+01 2.018750047683715820e+01
1.647222304344177246e+01 1.647222304344177246e+01 1.647222304344177246e+01 1.647222304344177246e+01 1.647222304344177246e+01 1.647222304344177246e+01 1.647222304344177246e+01 1.647222304344177246e+01 1.647222304344177246e+01 1.647222304344177246e+01 1.647222304344177246e+01 1.647222304344177246e+01 1.754444498221079485e+01 1.754444498221079485e+01 1.903333438237508091e+01 1.954166692495346069e+01 1.993650883720034628e+01 1.993650883720034628e+01 1.993650883720034628e+01 2.270833427459001541e+01 2.266666793823242543e+01 2.266666793823242543e+01 2.168750110268592834e+01 2.094583426713943552e+01 2.018750047683715820e+01 1.954166692495346069e+01
1.647222304344177246e+01 1.647222304344177246e+01 1.647222304344177246e+01 1.647222304344177246e+01 1.647222304344177246e+01 1.647222304344177246e+01 1.647222304344177246e+01 1.647222304344177246e+01 1.647222304344177246e+01 1.647222304344177246e+01 1.647222304344177246e+01 1.647222304344177246e+01 1.754444498221079485e+01 1.903333438237508091e+01 1.903333438237508091e+01 1.924074125289916992e+01 1.993650883720034628e+01 1.993650883720034628e+01 2.270833427459001541e+01 2.168750110268592834e+01 2.168750110268592834e+01 2.263888953129450599e+01 2.270833427459001541e+01 2.215555637677510603e+01 2.094583426713943552e+01 2.094583426713943552e+01
1.647222304344177246e+01 1.647222304344177246e+01 1.647222304344177246e+01 1.647222304344177246e+01 1.647222304344177246e+01 1.647222304344177246e+01 1.647222304344177246e+01 1.647222304344177246e+01 1.647222304344177246e+01 1.647222304344177246e+01 1.647222304344177246e+01 1.754444498221079485e+01 1.754444498221079485e+01 1.903333438237508091e+01 1.840277860562006396e+01 1.924074125289916992e+01 1.993650883720034628e+01 1.993650883720034628e+01 2.270833427459001541e+01 2.388888945844438183e+01 2.403333436648050991e+01 2.263888953129450599e+01 2.403333436648050991e+01 2.266666793823242543e+01 2.256666779518127441e+01 2.215555637677510603e+01
1.647222304344177246e+01 1.647222304344177246e+01 1.647222304344177246e+01 1.647222304344177246e+01 1.647222304344177246e+01 1.647222304344177246e+01 1.647222304344177246e+01 1.647222304344177246e+01 1.647222304344177246e+01 1.647222304344177246e+01 1.647222304344177246e+01 1.647222304344177246e+01 1.754444498221079485e+01 1.754444498221079485e+01 1.881333393096923601e+01 1.954166692495346069e+01 1.993650883720034628e+01 1.993650883720034628e+01 2.122222383817037183e+01 2.309333412170410327e+01 2.270833427459001541e+01 2.263888953129450599e+01 2.270833427459001541e+01 2.263888953129450599e+01 2.256666779518127441e+01 2.168750110268592834e+01
1.647222304344177246e+01 1.647222304344177246e+01 1.647222304344177246e+01 1.647222304344177246e+01 1.647222304344177246e+01 1.647222304344177246e+01 1.647222304344177246e+01 1.647222304344177246e+01 1.647222304344177246e+01 1.647222304344177246e+01 1.647222304344177246e+01 1.647222304344177246e+01 1.647222304344177246e+01 1.754444498221079485e+01 1.754444498221079485e+01 1.881333393096923601e+01 1.924074125289916992e+01 1.993650883720034628e+01 1.993650883720034628e+01 2.263888953129450599e+01 2.263888953129450599e+01 2.256666779518127441e+01 2.256666779518127441e+01 2.309333412170410327e+01 2.309333412170410327e+01 2.094583426713943552e+01
1.647222304344177246e+01 1.647222304344177246e+01 1.647222304344177246e+01 1.647222304344177246e+01 1.647222304344177246e+01 1.647222304344177246e+01 1.647222304344177246e+01 1.647222304344177246e+01 1.647222304344177246e+01 1.647222304344177246e+01 1.647222304344177246e+01 1.647222304344177246e+01 1.647222304344177246e+01 1.754444498221079485e+01 1.754444498221079485e+01 1.840277860562006396e+01 1.881333393096923601e+01 1.754444498221079485e+01 1.754444498221079485e+01 1.954166692495346069e+01 2.263888953129450599e+01 2.263888953129450599e+01 2.309333412170410327e+01 2.263888953129450599e+01 2.168750110268592834e+01 2.094583426713943552e+01
1.993650883720034628e+01 1.993650883720034628e+01 1.840277860562006396e+01 1.647222304344177246e+01 1.647222304344177246e+01 1.647222304344177246e+01 1.647222304344177246e+01 1.647222304344177246e+01 1.647222304344177246e+01 1.647222304344177246e+01 1.647222304344177246e+01 1.647222304344177246e+01 1.754444498221079485e+01 1.754444498221079485e+01 1.840277860562006396e+01 1.840277860562006396e+01 1.840277860562006396e+01 1.840277860562006396e+01 1.881333393096923601e+01 1.881333393096923601e+01 2.263888953129450599e+01 2.403333436648050991e+01 2.526495784368270137e+01 2.263888953129450599e+01 2.168750110268592834e+01 2.168750110268592834e+01
1.993650883720034628e+01 1.993650883720034628e+01 1.993650883720034628e+01 1.647222304344177246e+01 1.647222304344177246e+01 1.647222304344177246e+01 1.647222304344177246e+01 1.647222304344177246e+01 1.647222304344177246e+01 1.647222304344177246e+01 1.647222304344177246e+01 1.647222304344177246e+01 1.647222304344177246e+01 1.754444498221079485e+01 1.840277860562006396e+01 1.840277860562006396e+01 2.080000127156575473e+01 2.080000127156575473e+01 2.256666779518127441e+01 2.270833427459001541e+01 2.270833427459001541e+01 2.388888945844438183e+01 2.403333436648050991e+01 2.263888953129450599e+01 2.168750110268592834e+01 1.954166692495346069e+01
1.993650883720034628e+01 1.993650883720034628e+01 1.993650883720034628e+01 1.647222304344177246e+01 1.647222304344177246e+01 1.647222304344177246e+01 1.647222304344177246e+01 1.647222304344177246e+01 1.647222304344177246e+01 1.647222304344177246e+01 1.647222304344177246e+01 1.647222304344177246e+01 1.647222304344177246e+01 1.754444498221079485e+01 1.954166692495346069e+01 2.094583426713943552e+01 2.122222383817037183e+01 2.263888953129450599e+01 2.270833427459001541e+01 2.270833427459001541e+01 2.270833427459001541e+01 2.270833427459001541e+01 2.416666734218597412e+01 2.263888953129450599e+01 2.080000127156575473e+01 1.954166692495346069e+01
1.993650883720034628e+01 1.993650883720034628e+01 1.993650883720034628e+01 1.647222304344177246e+01 1.647222304344177246e+01 1.647222304344177246e+01 1.647222304344177246e+01 1.647222304344177246e+01 1.647222304344177246e+01 1.647222304344177246e+01 1.647222304344177246e+01 1.647222304344177246e+01 1.647222304344177246e+01 1.754444498221079485e+01 1.954166692495346069e+01 2.094583426713943552e+01 2.122222383817037183e+01 2.168750110268592834e+01 2.168750110268592834e+01 2.263888953129450599e+01 2.263888953129450599e+01 2.309333412170410327e+01 2.309333412170410327e+01 2.080000127156575473e+01 2.080000127156575473e+01 2.018750047683715820e+01
1.993650883720034628e+01 1.993650883720034628e+01 1.993650883720034628e+01 1.840277860562006396e+01 1.647222304344177246e+01 1.647222304344177246e+01 1.647222304344177246e+01 1.647222304344177246e+01 1.647222304344177246e+01 1.647222304344177246e+01 1.647222304344177246e+01 1.647222304344177246e+01 1.754444498221079485e+01 1.754444498221079485e+01 1.954166692495346069e+01 2.094583426713943552e+01 2.263888953129450599e+01 2.168750110268592834e+01 2.388888945844438183e+01 2.403333436648050991e+01 2.309333412170410327e+01 2.309333412170410327e+01 2.309333412170410327e+01 2.018750047683715820e+01 2.018750047683715820e+01 2.018750047683715820e+01
1.840277860562006396e+01 1.993650883720034628e+01 1.993650883720034628e+01 1.840277860562006396e+01 1.647222304344177246e+01 1.647222304344177246e+01 1.647222304344177246e+01 1.647222304344177246e+01 1.647222304344177246e+01 1.647222304344177246e+01 1.647222304344177246e+01 1.647222304344177246e+01 1.754444498221079485e+01 1.903333438237508091e+01 2.094583426713943552e+01 1.993650883720034628e+01 2.268055643637974939e+01 2.215555637677510603e+01 2.416666734218597412e+01 2.314285821006411581e+01 2.314285821006411581e+01 2.018750047683715820e+01 2.018750047683715820e+01 1.954166692495346069e+01 2.018750047683715820e+01 2.018750047683715820e+01
1.647222304344177246e+01 1.993650883720034628e+01 1.993650883720034628e+01 1.647222304344177246e+01 1.647222304344177246e+01 1.647222304344177246e+01 1.647222304344177246e+01 1.647222304344177246e+01 1.647222304344177246e+01 1.647222304344177246e+01 1.647222304344177246e+01 1.647222304344177246e+01 1.754444498221079485e+01 1.754444498221079485e+01 1.840277860562006396e+01 1.993650883720034628e+01 2.122222383817037183e+01 2.122222383817037183e+01 2.309333412170410327e+01 2.309333412170410327e+01 2.080000127156575473e+01 2.018750047683715820e+01 2.122222383817037183e+01 2.018750047683715820e+01 2.018750047683715820e+01 1.993650883720034628e+01
1.647222304344177246e+01 1.993650883720034628e+01 1.993650883720034628e+01 1.647222304344177246e+01 1.647222304344177246e+01 1.647222304344177246e+01 1.647222304344177246e+01 1.647222304344177246e+01 1.647222304344177246e+01 1.647222304344177246e+01 1.647222304344177246e+01 1.647222304344177246e+01 1.647222304344177246e+01 1.754444498221079485e+01 1.881333393096923601e+01 1.754444498221079485e+01 2.168750110268592834e+01 1.954166692495346069e+01 2.263888953129450599e+01 2.094583426713943552e+01 2.094583426713943552e+01 2.215555637677510603e+01 2.270833427459001541e+01 2.094583426713943552e+01 2.094583426713943552e+01 1.954166692495346069e+01
1.647222304344177246e+01 1.993650883720034628e+01 1.993650883720034628e+01 1.840277860562006396e+01 1.647222304344177246e+01 1.647222304344177246e+01 1.647222304344177246e+01 1.647222304344177246e+01 1.647222304344177246e+01 1.647222304344177246e+01 1.647222304344177246e+01 1.647222304344177246e+01 1.647222304344177246e+01 1.881333393096923601e+01 1.881333393096923601e+01 1.881333393096923601e+01 1.881333393096923601e+01 1.881333393096923601e+01 1.954166692495346069e+01 2.168750110268592834e+01 2.168750110268592834e+01 2.168750110268592834e+01 2.270833427459001541e+01 2.256666779518127441e+01 2.215555637677510603e+01 1.954166692495346069e+01
1.647222304344177246e+01 1.993650883720034628e+01 1.993650883720034628e+01 1.840277860562006396e+01 1.647222304344177246e+01 1.647222304344177246e+01 1.647222304344177246e+01 1.647222304344177246e+01 1.647222304344177246e+01 1.647222304344177246e+01 1.647222304344177246e+01 1.647222304344177246e+01 1.647222304344177246e+01 1.840277860562006396e+01 1.840277860562006396e+01 1.840277860562006396e+01 1.881333393096923601e+01 1.647222304344177246e+01 1.754444498221079485e+01 1.754444498221079485e+01 2.263888953129450599e+01 2.263888953129450599e+01 2.263888953129450599e+01 2.256666779518127441e+01 2.122222383817037183e+01 2.122222383817037183e+01
1.647222304344177246e+01 1.993650883720034628e+01 1.993650883720034628e+01 1.647222304344177246e+01 1.647222304344177246e+01 1.647222304344177246e+01 1.647222304344177246e+01 1.647222304344177246e+01 1.647222304344177246e+01 1.647222304344177246e+01 1.647222304344177246e+01 1.647222304344177246e+01 1.647222304344177246e+01 1.647222304344177246e+01 1.840277860562006396e+01 1.840277860562006396e+01 1.647222304344177246e+01 1.647222304344177246e+01 1.647222304344177246e+01 1.754444498221079485e+01 1.754444498221079485e+01 1.954166692495346069e+01 2.263888953129450599e+01 2.080000127156575473e+01 2.080000127156575473e+01 2.018750047683715820e+01
1.647222304344177246e+01 1.993650883720034628e+01 1.993650883720034628e+01 1.647222304344177246e+01 1.647222304344177246e+01 1.647222304344177246e+01 1.647222304344177246e+01 1.647222304344177246e+01 1.647222304344177246e+01 1.647222304344177246e+01 1.647222304344177246e+01 1.647222304344177246e+01 1.647222304344177246e+01 1.840277860562006396e+01 1.840277860562006396e+01 1.840277860562006396e+01 1.647222304344177246e+01 1.647222304344177246e+01 1.647222304344177246e+01 1.647222304344177246e+01 1.754444498221079485e+01 1.881333393096923601e+01 1.954166692495346069e+01 1.954166692495346069e+01 2.168750110268592834e+01 1.954166692495346069e+01
