1.963888986905415734e+01 1.963888986905415734e+01 1.963888986905415734e+01 1.963888986905415734e+01 1.963888986905415734e+01 1.963888986905415734e+01 1.963888986905415734e+01 1.963888986905415734e+01 1.963888986905415734e+01 1.963888986905415734e+01 1.963888986905415734e+01 1.963888986905415734e+01 1.963888986905415734e+01 1.963888986905415734e+01 1.963888986905415734e+01 1.963888986905415734e+01 1.963888986905415734e+01 1.963888986905415734e+01 1.963888986905415734e+01 1.963888986905415734e+01 1.963888986905415734e+01 1.963888986905415734e+01 1.963888986905415734e+01 1.963888986905415734e+01 1.963888986905415734e+01 1.963888986905415734e+01
1.963888986905415734e+01 1.963888986905415734e+01 1.963888986905415734e+01 1.963888986905415734e+01 1.963888986905415734e+01 1.963888986905415734e+01 1.963888986905415734e+01 1.963888986905415734e+01 1.963888986905415734e+01 1.963888986905415734e+01 1.963888986905415734e+01 1.963888986905415734e+01 1.963888986905415734e+01 1.963888986905415734e+01 1.963888986905415734e+01 1.963888986905415734e+01 1.963888986905415734e+01 1.963888986905415734e+01 1.963888986905415734e+01 1.963888986905415734e+01 1.963888986905415734e+01 1.963888986905415734e+01 1.963888986905415734e+01 1.963888986905415734e+01 1.963888986905415734e+01 1.963888986905415734e+01
1.963888986905415734e+01 1.963888986905415734e+01 1.963888986905415734e+01 1.963888986905415734e+01 1.963888986905415734e+01 1.963888986905415734e+01 1.963888986905415734e+01 1.963888986905415734e+01 1.963888986905415734e+01 1.963888986905415734e+01 1.963888986905415734e+01 1.963888986905415734e+01 1.963888986905415734e+01 1.963888986905415734e+01 1.963888986905415734e+01 1.963888986905415734e+01 1.963888986905415734e+01 1.963888986905415734e+01 1.963888986905415734e+01 1.963888986905415734e+01 1.963888986905415734e+01 1.963888986905415734e+01 1.963888986905415734e+01 1.963888986905415734e+01 1.963888986905415734e+01 1.963888986905415734e+01
1.963888986905415734e+01 1.963888986905415734e+01 1.963888986905415734e+01 1.963888986905415734e+01 1.963888986905415734e+01 1.963888986905415734e+01 1.963888986905415734e+01 1.963888986905415734e+01 1.963888986905415734e+01 1.963888986905415734e+01 1.963888986905415734e+01 1.963888986905415734e+01 1.963888986905415734e+01 1.963888986905415734e+01 1.963888986905415734e+01 1.963888986905415734e+01 1.963888986905415734e+01 1.963888986905415734e+01 1.963888986905415734e+01 1.963888986905415734e+01 1.963888986905415734e+01 1.963888986905415734e+01 1.963888986905415734e+01 1.963888986905415734e+01 1.963888986905415734e+01 1.963888986905415734e+01
1.963888986905415734e+01 1.963888986905415734e+01 1.963888986905415734e+01 1.963888986905415734e+01 1.963888986905415734e+01 1.963888986905415734e+01 1.963888986905415734e+01 1.963888986905415734e+01 1.963888986905415734e+01 1.963888986905415734e+01 1.963888986905415734e+01 1.963888986905415734e+01 1.963888986905415734e+01 1.963888986905415734e+01 1.963888986905415734e+01 1.963888986905415734e+01 1.963888986905415734e+01 1.963888986905415734e+01 1.963888986905415734e+01 1.963888986905415734e+01 1.963888986905415734e+01 1.963888986905415734e+01 1.963888986905415734e+01 1.963888986905415734e+01 1.963888986905415734e+01 1.963888986905415734e+01
1.963888986905415734e+01 1.963888986905415734e+01 1.963888986905415734e+01 1.963888986905415734e+01 1.963888986905415734e+01 1.963888986905415734e+01 1.963888986905415734e+01 1.963888986905415734e+01 1.963888986905415734e+01 1.963888986905415734e+01 1.963888986905415734e+01 1.963888986905415734e+01 1.963888986905415734e+01 1.963888986905415734e+01 1.963888986905415734e+01 1.963888986905415734e+01 1.963888986905415734e+01 1.963888986905415734e+01 1.963888986905415734e+01 1.963888986905415734e+01 1.963888986905415734e+01 1.963888986905415734e+01 1.963888986905415734e+01 1.963888986905415734e+01 1.963888986905415734e+01 1.963888986905415734e+01
1.963888986905415734e+01 1.963888986905415734e+01 1.963888986905415734e+01 1.963888986905415734e+01 1.963888986905415734e+01 1.963888986905415734e+01 1.963888986905415734e+01 1.963888986905415734e+01 1.963888986905415734e+01 1.963888986905415734e+01 1.963888986905415734e+01 1.963888986905415734e+01 1.963888986905415734e+01 1.963888986905415734e+01 1.963888986905415734e+01 1.963888986905415734e+01 1.963888986905415734e+01 1.963888986905415734e+01 1.963888986905415734e+01 1.963888986905415734e+01 1.963888986905415734e+01 1.963888986905415734e+01 1.963888986905415734e+01 1.963888986905415734e+01 1.963888986905415734e+01 1.963888986905415734e+01
1.963888986905415734e+01 1.963888986905415734e+01 1.963888986905415734e+01 1.963888986905415734e+01 1.963888986905415734e+01 1.963888986905415734e+01 1.963888986905415734e+01 1.963888986905415734e+01 1.963888986905415734e+01 1.963888986905415734e+01 1.963888986905415734e+01 1.963888986905415734e+01 1.963888986905415734e+01 1.963888986905415734e+01 1.963888986905415734e+01 1.963888986905415734e+01 1.963888986905415734e+01 1.963888986905415734e+01 1.963888986905415734e+01 1.963888986905415734e+01 1.963888986905415734e+01 1.963888986905415734e+01 1.963888986905415734e+01 1.963888986905415734e+01 1.963888986905415734e+01 1.963888986905415734e+01
1.963888986905415734e+01 1.963888986905415734e+01 1.963888986905415734e+01 1.963888986905415734e+01 1.963888986905415734e+01 1.963888986905415734e+01 1.963888986905415734e+01 1.963888986905415734e+01 1.963888986905415734e+01 1.963888986905415734e+01 1.963888986905415734e+01 1.963888986905415734e+01 1.963888986905415734e+01 1.963888986905415734e+01 1.963888986905415734e+01 1.963888986905415734e+01 1.963888986905415734e+01 1.963888986905415734e+01 1.963888986905415734e+01 1.963888986905415734e+01 1.963888986905415734e+01 1.963888986905415734e+01 1.963888986905415734e+01 1.963888986905415734e+01 1.963888986905415734e+01 1.963888986905415734e+01
1.963888986905415734e+01 1.963888986905415734e+01 1.963888986905415734e+01 1.963888986905415734e+01 1.963888986905415734e+01 1.963888986905415734e+01 1.963888986905415734e+01 1.963888986905415734e+01 1.963888986905415734e+01 1.963888986905415734e+01 1.963888986905415734e+01 1.963888986905415734e+01 1.963888986905415734e+01 1.963888986905415734e+01 1.963888986905415734e+01 1.963888986905415734e+01 1.963888986905415734e+01 1.963888986905415734e+01 1.963888986905415734e+01 1.963888986905415734e+01 1.963888986905415734e+01 1.963888986905415734e+01 1.963888986905415734e+01 1.963888986905415734e+01 1.963888986905415734e+01 1.963888986905415734e+01
1.963888986905415734e+01 1.963888986905415734e+01 1.963888986905415734e+01 1.963888986905415734e+01 1.963888986905415734e+01 1.963888986905415734e+01 1.963888986905415734e+01 1.963888986905415734e+01 1.963888986905415734e+01 1.963888986905415734e+01 1.963888986905415734e+01 1.963888986905415734e+01 1.963888986905415734e+01 1.963888986905415734e+01 1.963888986905415734e+01 1.963888986905415734e+01 1.963888986905415734e+01 1.963888986905415734e+01 1.963888986905415734e+01 1.963888986905415734e+01 1.963888986905415734e+01 1.963888986905415734e+01 1.963888986905415734e+01 1.963888986905415734e+01 1.963888986905415734e+01 1.963888986905415734e+01
1.963888986905415734e+01 1.963888986905415734e+01 1.963888986905415734e+01 1.963888986905415734e+01 1.963888986905415734e+01 1.963888986905415734e+01 1.963888986905415734e+01 1.963888986905415734e+01 1.963888986905415734e+01 1.963888986905415734e+01 1.963888986905415734e+01 1.963888986905415734e+01 1.963888986905415734e+01 1.963888986905415734e+01 1.963888986905415734e+01 1.963888986905415734e+01 1.963888986905415734e+01 1.963888986905415734e+01 1.963888986905415734e+01 1.963888986905415734e+01 1.963888986905415734e+01 1.963888986905415734e+01 1.963888986905415734e+01 1.963888986905415734e+01 1.963888986905415734e+01 1.963888986905415734e+01
1.963888986905415734e+01 1.963888986905415734e+01 1.963888986905415734e+01 1.963888986905415734e+01 1.963888986905415734e+01 1.963888986905415734e+01 1.963888986905415734e+01 1.963888986905415734e+01 1.963888986905415734e+01 1.963888986905415734e+01 1.963888986905415734e+01 1.963888986905415734e+01 1.963888986905415734e+01 1.963888986905415734e+01 1.963888986905415734e+01 1.963888986905415734e+01 1.963888986905415734e+01 1.963888986905415734e+01 1.963888986905415734e+01 1.963888986905415734e+01 1.963888986905415734e+01 1.963888986905415734e+01 1.963888986905415734e+01 1.963888986905415734e+01 1.963888986905415734e+01 1.963888986905415734e+01
1.556190529125077227e+01 1.556190529125077227e+01 0.000000000000000000e+00 0.000000000000000000e+00 0.000000000000000000e+00 0.000000000000000000e+00 1.556190529125077227e+01 1.556190529125077227e+01 0.000000000000000000e+00 0.000000000000000000e+00 0.000000000000000000e+00 0.000000000000000000e+00 0.000000000000000000e+00 0.000000000000000000e+00 0.000000000000000000e+00 0.000000000000000000e+00 0.000000000000000000e+00 0.000000000000000000e+00 0.000000000000000000e+00 0.000000000000000000e+00 0.000000000000000000e+00 0.000000000000000000e+00 0.000000000000000000e+00 0.000000000000000000e+00 0.000000000000000000e+00 0.000000000000000000e+00
1.556190529125077227e+01 1.556190529125077227e+01 1.556190529125077227e+01 1.556190529125077227e+01 1.556190529125077227e+01 1.556190529125077227e+01 1.556190529125077227e+01 1.556190529125077227e+01 1.556190529125077227e+01 1.556190529125077227e+01 1.556190529125077227e+01 1.556190529125077227e+01 0.000000000000000000e+00 0.000000000000000000e+00 0.000000000000000000e+00 1.556190529125077227e+01 1.556190529125077227e+01 1.556190529125077227e+01 1.556190529125077227e+01 1.556190529125077227e+01 1.556190529125077227e+01 1.556190529125077227e+01 0.000000000000000000e+00 1.556190529125077227e+01 1.556190529125077227e+01 1.556190529125077227e+01
1.963888986905415734e+01 1.963888986905415734e+01 2.068518590927124023e+01 2.068518590927124023e+01 2.068518590927124023e+01 2.068518590927124023e+01 2.068518590927124023e+01 2.068518590927124023e+01 2.068518590927124023e+01 2.068518590927124023e+01 2.068518590927124023e+01 2.068518590927124023e+01 2.068518590927124023e+01 2.068518590927124023e+01 2.068518590927124023e+01 2.068518590927124023e+01 2.068518590927124023e+01 2.068518590927124023e+01 2.068518590927124023e+01 2.068518590927124023e+01 2.068518590927124023e+01 2.068518590927124023e+01 2.068518590927124023e+01 2.068518590927124023e+01 2.068518590927124023e+01 1.963888986905415734e+01
1.963888986905415734e+01 1.963888986905415734e+01 1.963888986905415734e+01 1.963888986905415734e+01 1.963888986905415734e+01 1.963888986905415734e+01 1.963888986905415734e+01 1.963888986905415734e+01 2.362963023715548871e+01 2.362963023715548871e+01 2.543750101327896118e+01 2.858333500226338586e+01 2.858333500226338586e+01 2.858333500226338586e+01 2.858333500226338586e+01 2.858333500226338586e+01 2.858333500226338586e+01 1.963888986905415734e+01 2.362963023715548871e+01 2.362963023715548871e+01 2.068518590927124023e+01 2.068518590927124023e+01 2.068518590927124023e+01 2.068518590927124023e+01 2.068518590927124023e+01 1.963888986905415734e+01
1.669697036165179682e+01 1.669697036165179682e+01 1.669697036165179682e+01 1.669697036165179682e+01 1.669697036165179682e+01 1.963888986905415734e+01 1.963888986905415734e+01 1.997916775941848755e+01 2.201754460836711758e+01 2.382222326066758455e+01 2.502083426713943481e+01 2.709848588163202265e+01 2.733333428700764856e+01 2.246296374003092566e+01 2.855769349978520211e+01 2.833333492279052734e+01 2.855769349978520211e+01 2.733333428700764856e+01 2.382222326066758455e+01 2.315555686950683878e+01 1.963888986905415734e+01 1.669697036165179682e+01 1.964583417773246765e+01 1.556190529125077227e+01 1.556190529125077227e+01 1.556190529125077227e+01
1.669697036165179682e+01 1.669697036165179682e+01 1.669697036165179682e+01 1.669697036165179682e+01 1.669697036165179682e+01 1.556190529125077227e+01 1.963888986905415734e+01 2.001785818168094977e+01 2.160000063896179157e+01 2.413889033595721045e+01 2.638888994852701941e+01 2.688888956705729072e+01 2.716666752099990845e+01 2.861111251513163367e+01 2.852381099973406009e+01 2.861111251513163367e+01 2.622222264607747277e+01 2.900000045413063177e+01 2.382222326066758455e+01 2.315555686950683878e+01 1.963888986905415734e+01 1.669697036165179682e+01 1.964583417773246765e+01 1.556190529125077227e+01 1.556190529125077227e+01 1.556190529125077227e+01
1.669697036165179682e+01 1.669697036165179682e+01 1.669697036165179682e+01 1.669697036165179682e+01 1.669697036165179682e+01 1.669697036165179682e+01 1.963888986905415734e+01 1.556190529125077227e+01 2.036111183961232385e+01 2.348958408832550049e+01 2.525000206629435340e+01 2.587963030073377979e+01 2.716666752099990845e+01 2.861111251513163367e+01 2.860000066757202219e+01 2.855555613835652551e+01 2.543750101327896118e+01 2.382222326066758455e+01 2.358039302825927663e+01 2.185416747629642487e+01 1.963888986905415734e+01 1.669697036165179682e+01 1.964583417773246765e+01 1.556190529125077227e+01 1.556190529125077227e+01 1.556190529125077227e+01
1.669697036165179682e+01 1.669697036165179682e+01 1.669697036165179682e+01 1.669697036165179682e+01 1.669697036165179682e+01 1.669697036165179682e+01 1.669697036165179682e+01 1.963888986905415734e+01 1.963888986905415734e+01 2.246296374003092566e+01 2.382222326066758455e+01 2.638888994852701941e+01 2.587963030073377979e+01 2.858333500226338586e+01 2.858333500226338586e+01 2.638888994852701941e+01 2.734722248713175574e+01 2.413889033595721045e+01 2.502083426713943481e+01 2.362963023715548871e+01 1.963888986905415734e+01 1.669697036165179682e+01 1.669697036165179682e+01 1.556190529125077227e+01 1.556190529125077227e+01 1.556190529125077227e+01
1.669697036165179682e+01 1.669697036165179682e+01 1.669697036165179682e+01 1.669697036165179682e+01 1.669697036165179682e+01 1.669697036165179682e+01 1.669697036165179682e+01 1.669697036165179682e+01 1.963888986905415734e+01 2.075000123977661204e+01 2.413889033595721045e+01 2.622222264607747277e+01 2.709848588163202265e+01 2.733333428700764856e+01 2.858333500226338586e+01 2.858333500226338586e+01 2.587963030073377979e+01 2.473958392441272736e+01 2.533333435925570498e+01 2.406250095367431641e+01 1.963888986905415734e+01 1.669697036165179682e+01 1.964583417773246765e+01 1.556190529125077227e+01 1.556190529125077227e+01 1.556190529125077227e+01
1.669697036165179682e+01 1.669697036165179682e+01 1.669697036165179682e+01 1.669697036165179682e+01 1.669697036165179682e+01 1.669697036165179682e+01 1.669697036165179682e+01 1.669697036165179682e+01 1.963888986905415734e+01 1.978125059604644775e+01 1.979761990479060785e+01 2.473958392441272736e+01 2.774074194166395557e+01 2.782222300635443446e+01 2.748148250579833984e+01 2.752777882417042932e+01 2.571605069548995459e+01 2.520238215582711661e+01 2.533333435925570498e+01 2.450666744232177763e+01 2.413333430290222026e+01 1.669697036165179682e+01 1.964583417773246765e+01 1.556190529125077227e+01 1.556190529125077227e+01 1.556190529125077227e+01
1.669697036165179682e+01 1.669697036165179682e+01 1.669697036165179682e+01 1.669697036165179682e+01 1.669697036165179682e+01 1.669697036165179682e+01 1.669697036165179682e+01 1.669697036165179682e+01 1.963888986905415734e+01 1.963888986905415734e+01 1.964583417773246765e+01 2.382222326066758455e+01 2.774074194166395557e+01 2.816666754086812219e+01 2.774074194166395557e+01 2.833333440621693811e+01 2.733333428700764856e+01 2.687500119209289551e+01 2.550000057220458771e+01 2.531111208597819129e+01 2.416666714350382605e+01 1.669697036165179682e+01 1.669697036165179682e+01 1.556190529125077227e+01 1.556190529125077227e+01 1.556190529125077227e+01
1.669697036165179682e+01 1.669697036165179682e+01 1.669697036165179682e+01 1.669697036165179682e+01 1.669697036165179682e+01 1.669697036165179682e+01 1.669697036165179682e+01 1.669697036165179682e+01 1.669697036165179682e+01 1.963888986905415734e+01 2.109596051230575142e+01 2.382222326066758455e+01 2.638888994852701941e+01 2.774074194166395557e+01 2.782222300635443446e+01 2.821666765213012695e+01 2.673333454132080078e+01 2.664583456516265869e+01 2.587963030073377979e+01 2.473958392441272736e+01 2.531111208597819129e+01 1.963888986905415734e+01 1.669697036165179682e+01 1.964583417773246765e+01 1.556190529125077227e+01 1.556190529125077227e+01
1.669697036165179682e+01 1.669697036165179682e+01 1.669697036165179682e+01 1.669697036165179682e+01 1.669697036165179682e+01 1.669697036165179682e+01 1.669697036165179682e+01 1.669697036165179682e+01 1.669697036165179682e+01 1.963888986905415734e+01 2.070833434164524078e+01 2.413889033595721045e+01 2.638888994852701941e+01 2.774074194166395557e+01 2.677083474397659302e+01 2.821666765213012695e+01 2.850000047683715820e+01 2.855769349978520211e+01 2.700000190734863281e+01 2.734722248713175574e+01 2.733333428700764856e+01 1.963888986905415734e+01 1.669697036165179682e+01 1.669697036165179682e+01 1.556190529125077227e+01 1.556190529125077227e+01
