1.123320616475907485e+01 1.123320616475907485e+01 1.123320616475907485e+01 2.151258903102433706e+01 2.898092506066986118e+01 4.207376769714919362e+01 6.020920298117491143e+01 7.087709864878031851e+01 7.653350879947311114e+01 8.453262846498745375e+01 8.439944877862188832e+01 8.914410929064028721e+01 8.267346879675268667e+01 6.834889311077886020e+01 4.822691993012867329e+01 3.080237484539033588e+01 2.049002952487080975e+01 1.123320616475907485e+01
1.123320616475907485e+01 1.123320616475907485e+01 1.123320616475907485e+01 2.052358322112012345e+01 2.791452351151508893e+01 4.089527327670337087e+01 5.350360877814581073e+01 5.889668729265378744e+01 6.396757409843558406e+01 7.174678228519177026e+01 7.594971174920202373e+01 8.590249406581295943e+01 8.930976231246660291e+01 7.717493855227309041e+01 5.857327672064656809e+01 4.107898700479087495e+01 2.364431130350009269e+01 1.824250036165754807e+01
1.123320616475907485e+01 1.123320616475907485e+01 1.123320616475907485e+01 1.237970100901352133e+01 2.361477138187780511e+01 3.275266647993864666e+01 4.257148120841039685e+01 4.257148120841039685e+01 4.266919860547310606e+01 4.726443183693584871e+01 6.115717323006860084e+01 7.398098520563712555e+01 8.395146365568803049e+01 8.267346879675268667e+01 6.507556119338603651e+01 4.318975833904346473e+01 2.621267856141273356e+01 1.824250036165754807e+01
1.123320616475907485e+01 1.123320616475907485e+01 1.123320616475907485e+01 1.123320616475907485e+01 2.228350278240664650e+01 2.451518835279827968e+01 2.451518835279827968e+01 2.829580060968743993e+01 2.867544995366483107e+01 3.960792987953965394e+01 5.128861927636476281e+01 6.914698589469402634e+01 8.395146365568803049e+01 8.320613487154865595e+01 6.527537920408471450e+01 4.793637502005837803e+01 2.793091352207473221e+01 1.824250036165754807e+01
1.123320616475907485e+01 1.123320616475907485e+01 1.123320616475907485e+01 1.123320616475907485e+01 1.123320616475907485e+01 1.641573019376833642e+01 2.085986760283035224e+01 2.561344041580901632e+01 2.794489858477903965e+01 4.030621483682992334e+01 5.760152338945757577e+01 6.880134631706923187e+01 8.285332733648994008e+01 8.034264105994378724e+01 6.574143253830513345e+01 4.336408097459612776e+01 2.542811314857901550e+01 1.824250036165754807e+01
1.123320616475907485e+01 1.123320616475907485e+01 1.123320616475907485e+01 1.123320616475907485e+01 1.123320616475907485e+01 1.641573019376833642e+01 2.074217201957976187e+01 2.865658763408406173e+01 3.895252874763038164e+01 5.368089125866158184e+01 6.858904926971932525e+01 8.126415042648471854e+01 8.308779831476971367e+01 7.704265425802138623e+01 5.894880806933903727e+01 3.847673395734855006e+01 2.492974186294524941e+01 1.824250036165754807e+01
1.123320616475907485e+01 1.123320616475907485e+01 1.123320616475907485e+01 1.123320616475907485e+01 1.123320616475907485e+01 1.422394576571248415e+01 2.447672083153234723e+01 3.751020995117742274e+01 5.395869024250990265e+01 7.213600636562017598e+01 8.882260156250372063e+01 9.049887074390761654e+01 9.251188582167588947e+01 7.112134406496085148e+01 5.746919196200946800e+01 3.309268883856363175e+01 2.039628176122204550e+01 1.123320616475907485e+01
1.123320616475907485e+01 1.123320616475907485e+01 1.123320616475907485e+01 1.123320616475907485e+01 1.123320616475907485e+01 1.948548874111540741e+01 2.505772980185467347e+01 4.442322010824742051e+01 6.125142811272457521e+01 8.620177687132475342e+01 9.899946115899581400e+01 9.919103658779110333e+01 9.200580684505406737e+01 7.143518651598644453e+01 5.041312659367687843e+01 2.793091352207473221e+01 2.039628176122204550e+01 1.123320616475907485e+01
1.123320616475907485e+01 1.123320616475907485e+01 1.123320616475907485e+01 1.123320616475907485e+01 1.123320616475907485e+01 2.074217201957976187e+01 2.627253977728348033e+01 4.184723290810291729e+01 6.097776313163782902e+01 8.040754640706455803e+01 1.002625589291045003e+02 1.057187376291636696e+02 9.200580684505406737e+01 7.143518651598644453e+01 4.929564019710966960e+01 2.793091352207473221e+01 1.824250036165754807e+01 1.123320616475907485e+01
1.123320616475907485e+01 1.123320616475907485e+01 1.123320616475907485e+01 1.123320616475907485e+01 1.237970100901352133e+01 2.052358322112012345e+01 2.550186280544036066e+01 3.474270695282812937e+01 5.213817028744463755e+01 7.398098520563712555e+01 9.261862229621065978e+01 9.997317750160065941e+01 9.653783764023756930e+01 7.686098218188303122e+01 4.929564019710966960e+01 2.994394735015642439e+01 2.049002952487080975e+01 1.123320616475907485e+01
1.123320616475907485e+01 1.123320616475907485e+01 1.123320616475907485e+01 1.123320616475907485e+01 1.920913994706424788e+01 1.979007308638630391e+01 2.417203719385412342e+01 3.183938190509453747e+01 4.479803256401829259e+01 6.255821900402089852e+01 8.040754640706455803e+01 9.261862229621065978e+01 9.298171395384726168e+01 7.686098218188303122e+01 5.377160216755163447e+01 3.320909887045790043e+01 2.049002952487080975e+01 1.123320616475907485e+01
1.123320616475907485e+01 1.123320616475907485e+01 1.123320616475907485e+01 1.979007308638630391e+01 2.353383006540065736e+01 2.922713668323012115e+01 3.400606222463753170e+01 3.696888568584360257e+01 4.434902616100796280e+01 5.128861927636476281e+01 6.600464494719579989e+01 8.408941641357439778e+01 8.885679055729289644e+01 7.975309360096315459e+01 6.166216627730582900e+01 3.736328104958819551e+01 2.049002952487080975e+01 1.123320616475907485e+01
1.123320616475907485e+01 1.123320616475907485e+01 1.979007308638630391e+01 2.655141194584532016e+01 3.895252874763038164e+01 4.833661797060609189e+01 5.233794079898481044e+01 5.173102175008853010e+01 4.912313331856999099e+01 5.250309554686226932e+01 6.567237290885918810e+01 8.408941641357439778e+01 8.549151197948856407e+01 7.936015123581613295e+01 6.086177493621609358e+01 3.988704555876468305e+01 2.314976531118006520e+01 1.824250036165754807e+01
1.123320616475907485e+01 1.979007308638630391e+01 2.733849324707685469e+01 4.096233035146372004e+01 5.687893694518681542e+01 6.858904926971932525e+01 6.983469600245952336e+01 7.428345845030023042e+01 6.576298755110312300e+01 6.661735285761639602e+01 7.259434041621173606e+01 8.180285355488409493e+01 8.344047854687508448e+01 7.827952486399020415e+01 5.894880806933903727e+01 3.847673395734855006e+01 2.314976531118006520e+01 1.824250036165754807e+01
1.422394576571248415e+01 2.176212053338868202e+01 3.751020995117742274e+01 5.790067245278825681e+01 7.739439633673538310e+01 8.882260156250372063e+01 9.748686075775771087e+01 9.256015990863812704e+01 8.312780759395272412e+01 8.107651862585800018e+01 8.107651862585800018e+01 8.327810330934156013e+01 8.168796591577084598e+01 6.981283501477795994e+01 5.018077496204841736e+01 3.351989531009682111e+01 2.063668946969868045e+01 1.123320616475907485e+01
1.948548874111540741e+01 2.725989182296449798e+01 4.616956965004188618e+01 6.573547236704011709e+01 8.620177687132475342e+01 9.899946115899581400e+01 1.094886966452355068e+02 1.060093687126349522e+02 9.168571650243995919e+01 9.168571650243995919e+01 8.308779831476971367e+01 7.985272388795355880e+01 7.275278258920344854e+01 5.866056983232843436e+01 4.261024762002787725e+01 2.788207646909603810e+01 2.039628176122204550e+01 1.123320616475907485e+01
2.074217201957976187e+01 3.025829596583146852e+01 4.479803256401829259e+01 7.016220084064542561e+01 9.185267651734683625e+01 9.881401672593432295e+01 1.041238783246166122e+02 1.034348590171195070e+02 9.681885231933276259e+01 8.702091940006013715e+01 7.985272388795355880e+01 7.316609035503542202e+01 5.782642235466136782e+01 4.460611900825884391e+01 3.257005873791177919e+01 2.063668946969868045e+01 1.237970100901352133e+01 1.123320616475907485e+01
1.641573019376833642e+01 2.524352197177416812e+01 4.089527327670337087e+01 5.793169745321480946e+01 7.375441665187906892e+01 7.819836727739084381e+01 7.819836727739084381e+01 7.819836727739084381e+01 7.819836727739084381e+01 7.819836727739084381e+01 6.852762814585365447e+01 5.492520015652532095e+01 4.246191725118310956e+01 3.404526975259862098e+01 2.397854812049918749e+01 2.027388203168074554e+01 1.123320616475907485e+01 1.123320616475907485e+01
