1.116912102318879363e+01 1.116912102318879363e+01 1.116912102318879363e+01 1.116912102318879363e+01 1.116912102318879363e+01 1.116912102318879363e+01 1.935683703251568133e+01 2.309230668114208029e+01 2.744631791449531377e+01 3.092177638175175147e+01 3.456622855721776943e+01 3.456622855721776943e+01 3.858815498127590615e+01 3.858815498127590615e+01 2.985949093422361500e+01 2.884746801331188593e+01 2.049002952487080975e+01 1.271371997973997381e+01
1.116912102318879363e+01 1.116912102318879363e+01 1.116912102318879363e+01 1.116912102318879363e+01 1.116912102318879363e+01 1.935683703251568133e+01 2.744631791449531377e+01 3.270563707801752429e+01 3.933002267798903517e+01 4.297230244514204145e+01 4.297230244514204145e+01 4.297230244514204145e+01 4.500484614174676778e+01 4.297230244514204145e+01 4.297230244514204145e+01 3.965780918411503819e+01 2.969383579689096209e+01 2.049002952487080975e+01
1.116912102318879363e+01 1.116912102318879363e+01 1.116912102318879363e+01 1.116912102318879363e+01 1.935683703251568133e+01 2.670237278824825822e+01 3.367317598132982681e+01 4.720254824913945413e+01 4.912452732571319558e+01 4.937110500876956110e+01 4.937110500876956110e+01 4.937110500876956110e+01 4.937110500876956110e+01 4.937110500876956110e+01 4.961956143420731991e+01 4.899202878415491114e+01 3.236605743163888604e+01 2.476517350770033232e+01
1.116912102318879363e+01 1.116912102318879363e+01 1.116912102318879363e+01 1.935683703251568133e+01 2.670237278824825822e+01 3.630996120179507614e+01 4.720254824913945413e+01 5.568678804292557061e+01 5.301762920819282243e+01 5.301762920819282243e+01 4.550754958417931562e+01 4.282066622853757565e+01 4.995377498822042384e+01 5.416449966424701756e+01 5.120046569213562293e+01 4.903404189347364905e+01 3.743721170932563069e+01 2.512670562740665758e+01
1.116912102318879363e+01 1.116912102318879363e+01 1.874308077846814768e+01 2.174478756130369561e+01 3.333170596598689173e+01 4.720254824913945413e+01 5.056044010901226216e+01 5.301762920819282243e+01 5.301762920819282243e+01 4.550754958417931562e+01 4.054982226953381996e+01 3.823179121873995001e+01 4.762763406594685733e+01 5.416449966424701756e+01 5.301762920819282243e+01 5.010326541985300963e+01 3.743721170932563069e+01 2.512670562740665758e+01
1.116912102318879363e+01 1.116912102318879363e+01 1.935683703251568133e+01 2.952523846670918317e+01 4.125445806040308128e+01 5.416449966424701756e+01 6.046951149459255248e+01 5.010326541985300963e+01 4.202578863967419665e+01 3.396604918757704894e+01 3.231300146780272797e+01 4.133309030271583140e+01 4.593261297502926510e+01 5.056044010901226216e+01 5.301762920819282243e+01 4.342946133974110268e+01 3.256857186907306811e+01 2.026508544406563672e+01
1.116912102318879363e+01 1.116912102318879363e+01 2.174478756130369561e+01 3.261710427786448463e+01 4.593261297502926510e+01 5.802056805364819780e+01 6.046951149459255248e+01 5.186711104280638551e+01 3.965780918411503819e+01 3.782979815891489039e+01 4.425122603546256528e+01 4.720254824913945413e+01 5.568678804292557061e+01 5.301762920819282243e+01 5.010326541985300963e+01 3.950080513679782968e+01 3.047623365848322052e+01 2.026508544406563672e+01
1.116912102318879363e+01 1.271371997973997381e+01 2.215848467880670114e+01 3.232099719378036440e+01 4.762763406594685733e+01 5.802056805364819780e+01 6.506704467636413369e+01 5.828517176354038298e+01 4.899202878415491114e+01 4.961956143420731991e+01 5.184661697841848849e+01 5.568678804292557061e+01 6.046951149459255248e+01 5.301762920819282243e+01 4.342946133974110268e+01 3.396604918757704894e+01 2.403352346798011752e+01 1.116912102318879363e+01
1.116912102318879363e+01 1.236918157460575429e+01 2.215848467880670114e+01 3.232099719378036440e+01 4.762763406594685733e+01 5.802056805364819780e+01 6.200484013278620665e+01 6.200484013278620665e+01 5.828517176354038298e+01 5.961058917611699570e+01 5.961058917611699570e+01 6.474285885171609323e+01 6.035242447833135060e+01 4.945696472212788564e+01 3.566712617142626129e+01 2.497701775923392731e+01 2.169316292533046564e+01 1.116912102318879363e+01
1.116912102318879363e+01 1.116912102318879363e+01 2.215848467880670114e+01 2.938689591658477696e+01 4.380016816449965944e+01 4.995377498822042384e+01 5.986218044195902621e+01 6.200484013278620665e+01 6.200484013278620665e+01 6.806425015296186132e+01 7.069565590757541429e+01 6.956255232366181929e+01 5.873500910573353906e+01 4.334089625540422475e+01 3.161264712574649849e+01 2.026508544406563672e+01 1.116912102318879363e+01 1.116912102318879363e+01
1.116912102318879363e+01 1.116912102318879363e+01 1.236918157460575429e+01 2.507403282254260901e+01 3.185885154840470079e+01 4.540510875273775326e+01 4.995377498822042384e+01 5.986218044195902621e+01 6.688945606817020462e+01 7.069565590757541429e+01 7.100972626662165510e+01 6.492025683403419123e+01 4.945696472212788564e+01 3.566712617142626129e+01 2.403352346798011752e+01 1.116912102318879363e+01 1.116912102318879363e+01 1.116912102318879363e+01
1.116912102318879363e+01 1.116912102318879363e+01 1.116912102318879363e+01 1.644839936625927024e+01 2.507403282254260901e+01 3.185885154840470079e+01 4.162585793926432842e+01 4.995377498822042384e+01 6.688945606817020462e+01 6.923755284390102815e+01 6.956255232366181929e+01 5.499232325944376498e+01 3.982915307921044246e+01 2.612554513884161622e+01 2.026508544406563672e+01 1.116912102318879363e+01 1.116912102318879363e+01 1.116912102318879363e+01
1.116912102318879363e+01 1.116912102318879363e+01 1.116912102318879363e+01 1.116912102318879363e+01 2.225379179300702859e+01 2.507403282254260901e+01 3.605927113415239660e+01 4.762763406594685733e+01 6.025208695808477444e+01 6.275945429354126759e+01 5.499232325944376498e+01 4.771060302198218750e+01 3.404526975259862098e+01 2.403352346798011752e+01 1.116912102318879363e+01 1.116912102318879363e+01 1.116912102318879363e+01 1.116912102318879363e+01
1.116912102318879363e+01 1.116912102318879363e+01 1.116912102318879363e+01 1.116912102318879363e+01 1.935683703251568133e+01 2.447672083153234723e+01 3.506561510220461031e+01 5.065690572622476395e+01 6.113398102849675553e+01 6.275945429354126759e+01 4.945696472212788564e+01 3.566712617142626129e+01 2.497701775923392731e+01 2.012181234585622747e+01 1.116912102318879363e+01 1.116912102318879363e+01 1.116912102318879363e+01 1.116912102318879363e+01
1.116912102318879363e+01 1.116912102318879363e+01 1.116912102318879363e+01 1.116912102318879363e+01 2.149488827623791565e+01 2.952523846670918317e+01 4.125445806040308128e+01 5.416449966424701756e+01 5.301762920819282243e+01 5.012185917201306040e+01 3.904664213886510282e+01 2.612554513884161622e+01 2.026508544406563672e+01 1.236918157460575429e+01 1.236918157460575429e+01 1.236918157460575429e+01 1.271371997973997381e+01 1.116912102318879363e+01
1.116912102318879363e+01 1.116912102318879363e+01 1.116912102318879363e+01 1.935683703251568133e+01 2.670237278824825822e+01 3.630996120179507614e+01 5.065690572622476395e+01 5.802056805364819780e+01 5.301762920819282243e+01 3.950080513679782968e+01 3.256857186907306811e+01 2.026508544406563672e+01 1.428332658982030701e+01 1.236918157460575429e+01 1.874308077846814768e+01 1.966517290273010232e+01 1.966517290273010232e+01 1.271371997973997381e+01
1.116912102318879363e+01 1.116912102318879363e+01 1.271371997973997381e+01 2.174478756130369561e+01 3.333170596598689173e+01 4.593261297502926510e+01 5.056044010901226216e+01 5.301762920819282243e+01 4.945696472212788564e+01 3.566712617142626129e+01 2.403352346798011752e+01 1.428332658982030701e+01 1.428332658982030701e+01 1.874308077846814768e+01 2.208590257533386136e+01 2.199243214291224291e+01 2.158689270690556583e+01 2.076176829819922531e+01
1.116912102318879363e+01 1.116912102318879363e+01 1.935683703251568133e+01 2.777710443313699074e+01 4.125445806040308128e+01 5.056044010901226216e+01 5.301762920819282243e+01 5.012185917201306040e+01 3.904664213886510282e+01 2.612554513884161622e+01 2.026508544406563672e+01 1.236918157460575429e+01 1.644839936625927024e+01 1.935683703251568133e+01 2.250332840988343364e+01 2.250332840988343364e+01 2.592130837563189871e+01 2.351877595993232362e+01
