1.185240585485262699e+01 1.538446283509864543e+01 1.538446283509864543e+01 2.201736193011883813e+01 2.482360587680102526e+01 2.864697569329765159e+01 3.216792025079794826e+01 3.531999820759202180e+01 3.531999820759202180e+01 3.531999820759202180e+01 3.531999820759202180e+01 3.531999820759202180e+01 3.531999820759202180e+01 3.531999820759202180e+01 3.531999820759202180e+01 3.531999820759202180e+01 3.531999820759202180e+01 2.307868753190913935e+01
1.185240585485262699e+01 1.538446283509864543e+01 2.482360587680102526e+01 3.531999820759202180e+01 4.013896208105066421e+01 5.141952259470266995e+01 5.425057811504207450e+01 5.425057811504207450e+01 5.425057811504207450e+01 5.425057811504207450e+01 5.425057811504207450e+01 5.425057811504207450e+01 5.425057811504207450e+01 5.425057811504207450e+01 5.656333047130945602e+01 5.417560511442075466e+01 5.425057811504207450e+01 3.930068029054432799e+01
1.538446283509864543e+01 2.542201245711989799e+01 3.190250740667055851e+01 4.416357990029151637e+01 6.578430651438166876e+01 7.558608473049343957e+01 7.558608473049343957e+01 6.828279541982188050e+01 6.828279541982188050e+01 6.828279541982188050e+01 6.828279541982188050e+01 6.828279541982188050e+01 6.771676788254070800e+01 7.558608473049343957e+01 7.558608473049343957e+01 7.558608473049343957e+01 6.828279541982188050e+01 5.425057811504207450e+01
1.538446283509864543e+01 2.714552694501433905e+01 4.100572137343481671e+01 5.495577393615780437e+01 7.220620647778743262e+01 9.054849517510305645e+01 9.054849517510305645e+01 8.409588626253679422e+01 8.049394329831170580e+01 7.373540904332607226e+01 6.732757038831279317e+01 7.373540904332607226e+01 7.373540904332607226e+01 8.435309094580503597e+01 8.632484748993314838e+01 9.138908008807197803e+01 8.888244058550266402e+01 6.657740621082548671e+01
1.538446283509864543e+01 2.920769685750865818e+01 4.067132887159561250e+01 4.972484295221479300e+01 6.667771964031892651e+01 7.373540904332607226e+01 7.373540904332607226e+01 6.732757038831279317e+01 6.164847373428658983e+01 6.058803042206463374e+01 5.469081201192802411e+01 5.141952259470266995e+01 6.164847373428658983e+01 7.373540904332607226e+01 8.435309094580503597e+01 9.688616018787843132e+01 9.800100539140582612e+01 8.049394329831170580e+01
1.538446283509864543e+01 2.920769685750865818e+01 4.067132887159561250e+01 4.249321603187907925e+01 4.972484295221479300e+01 4.972484295221479300e+01 4.950389137347752211e+01 4.769870528598463011e+01 4.584315159030600739e+01 3.120522917044032951e+01 3.120522917044032951e+01 4.249321603187907925e+01 4.972484295221479300e+01 7.373540904332607226e+01 8.435309094580503597e+01 9.546597397406939933e+01 8.986744890271940278e+01 7.144093256602910458e+01
1.538446283509864543e+01 2.225377952752335631e+01 2.225377952752335631e+01 3.120522917044032951e+01 3.120522917044032951e+01 3.120522917044032951e+01 3.120522917044032951e+01 3.120522917044032951e+01 2.501156196615264804e+01 2.225377952752335631e+01 2.413204360896837386e+01 3.247402217624002674e+01 4.861400817863298585e+01 6.687209671228168872e+01 8.595066152016569561e+01 9.054849517510305645e+01 8.007883442568851251e+01 6.434715387785216478e+01
1.185240585485262699e+01 1.185240585485262699e+01 1.538446283509864543e+01 2.225377952752335631e+01 2.225377952752335631e+01 2.225377952752335631e+01 2.225377952752335631e+01 1.538446283509864543e+01 1.538446283509864543e+01 2.129092588674000552e+01 2.864697569329765159e+01 4.013896208105066421e+01 5.656333047130945602e+01 7.220620647778743262e+01 9.054849517510305645e+01 8.144809290190636375e+01 6.411643812633036532e+01 4.584315159030600739e+01
1.185240585485262699e+01 1.185240585485262699e+01 1.185240585485262699e+01 1.185240585485262699e+01 1.185240585485262699e+01 1.185240585485262699e+01 1.185240585485262699e+01 1.538446283509864543e+01 2.129092588674000552e+01 2.864697569329765159e+01 4.013896208105066421e+01 5.656333047130945602e+01 7.220620647778743262e+01 7.558608473049343957e+01 8.049394329831170580e+01 6.732757038831279317e+01 4.769870528598463011e+01 3.309667092825046097e+01
1.185240585485262699e+01 1.185240585485262699e+01 1.185240585485262699e+01 1.185240585485262699e+01 1.185240585485262699e+01 1.185240585485262699e+01 1.538446283509864543e+01 2.129092588674000552e+01 2.864697569329765159e+01 4.013896208105066421e+01 5.656333047130945602e+01 7.220620647778743262e+01 7.558608473049343957e+01 8.049394329831170580e+01 6.732757038831279317e+01 4.950389137347752211e+01 3.418206508066440108e+01 2.501156196615264804e+01
1.185240585485262699e+01 1.185240585485262699e+01 1.185240585485262699e+01 1.185240585485262699e+01 1.185240585485262699e+01 1.538446283509864543e+01 1.538446283509864543e+01 2.864697569329765159e+01 4.013896208105066421e+01 5.656333047130945602e+01 7.220620647778743262e+01 8.816650600129487714e+01 8.409588626253679422e+01 6.828279541982188050e+01 5.198899588693912932e+01 3.832072681396996217e+01 2.501156196615264804e+01 1.538446283509864543e+01
1.185240585485262699e+01 1.185240585485262699e+01 1.185240585485262699e+01 1.185240585485262699e+01 1.185240585485262699e+01 1.538446283509864543e+01 2.864697569329765159e+01 4.013896208105066421e+01 5.656333047130945602e+01 7.220620647778743262e+01 8.816650600129487714e+01 9.054849517510305645e+01 8.049394329831170580e+01 5.869985845784115952e+01 3.832072681396996217e+01 2.501156196615264804e+01 2.341733382790981466e+01 1.185240585485262699e+01
1.185240585485262699e+01 1.185240585485262699e+01 1.185240585485262699e+01 1.538446283509864543e+01 1.538446283509864543e+01 2.542201245711989799e+01 4.013896208105066421e+01 5.495577393615780437e+01 7.220620647778743262e+01 8.816650600129487714e+01 9.054849517510305645e+01 7.403733765284903257e+01 6.434715387785216478e+01 4.584315159030600739e+01 2.501156196615264804e+01 2.341733382790981466e+01 1.185240585485262699e+01 1.185240585485262699e+01
1.185240585485262699e+01 1.185240585485262699e+01 1.538446283509864543e+01 1.538446283509864543e+01 2.864697569329765159e+01 4.013896208105066421e+01 5.656333047130945602e+01 7.220620647778743262e+01 9.054849517510305645e+01 8.144809290190636375e+01 7.373540904332607226e+01 6.058803042206463374e+01 4.584315159030600739e+01 2.501156196615264804e+01 2.183859464735964906e+01 1.185240585485262699e+01 1.185240585485262699e+01 1.185240585485262699e+01
1.185240585485262699e+01 1.538446283509864543e+01 2.129092588674000552e+01 2.864697569329765159e+01 4.013896208105066421e+01 5.656333047130945602e+01 7.220620647778743262e+01 7.558608473049343957e+01 8.144809290190636375e+01 7.059349912696190188e+01 5.860180292380270117e+01 3.832072681396996217e+01 2.501156196615264804e+01 2.341733382790981466e+01 1.185240585485262699e+01 1.185240585485262699e+01 1.185240585485262699e+01 1.185240585485262699e+01
1.538446283509864543e+01 2.201736193011883813e+01 2.864697569329765159e+01 4.416357990029151637e+01 5.656333047130945602e+01 7.558608473049343957e+01 7.558608473049343957e+01 8.007883442568851251e+01 7.059349912696190188e+01 5.860180292380270117e+01 3.832072681396996217e+01 2.501156196615264804e+01 2.341733382790981466e+01 1.185240585485262699e+01 1.185240585485262699e+01 1.185240585485262699e+01 1.185240585485262699e+01 1.185240585485262699e+01
2.201736193011883813e+01 3.531999820759202180e+01 4.416357990029151637e+01 6.578430651438166876e+01 7.558608473049343957e+01 8.816650600129487714e+01 8.144809290190636375e+01 7.059349912696190188e+01 5.588412828874561455e+01 3.832072681396996217e+01 2.501156196615264804e+01 2.341733382790981466e+01 1.185240585485262699e+01 1.185240585485262699e+01 1.185240585485262699e+01 1.185240585485262699e+01 1.185240585485262699e+01 1.185240585485262699e+01
3.531999820759202180e+01 5.141952259470266995e+01 6.578430651438166876e+01 7.558608473049343957e+01 9.054849517510305645e+01 8.144809290190636375e+01 7.059349912696190188e+01 5.860180292380270117e+01 3.832072681396996217e+01 2.501156196615264804e+01 2.341733382790981466e+01 1.185240585485262699e+01 1.185240585485262699e+01 1.185240585485262699e+01 1.185240585485262699e+01 1.185240585485262699e+01 1.185240585485262699e+01 1.185240585485262699e+01
