2.769076781572628576e+01 4.380182010480866239e+01 5.838232667714368773e+01 5.248238136208966154e+01 5.248238136208966154e+01 3.901874648958862934e+01 2.351307626217090885e+01 1.511463713658741526e+01 1.511463713658741526e+01 1.190524465010934740e+01 1.511463713658741526e+01 1.511463713658741526e+01 1.511463713658741526e+01 1.511463713658741526e+01 1.511463713658741526e+01 1.511463713658741526e+01 1.511463713658741526e+01 1.511463713658741526e+01
2.769076781572628576e+01 4.921443490259468234e+01 6.917298778477487531e+01 7.735689146036698105e+01 6.710196127848456626e+01 5.248238136208966154e+01 2.961767357504439602e+01 1.511463713658741526e+01 1.511463713658741526e+01 1.511463713658741526e+01 1.511463713658741526e+01 1.511463713658741526e+01 2.296635729660084380e+01 2.296635729660084380e+01 2.351307626217090885e+01 2.351307626217090885e+01 1.511463713658741526e+01 1.511463713658741526e+01
2.769076781572628576e+01 5.358140930012572767e+01 7.825640461518052859e+01 8.610807326909532833e+01 8.610807326909532833e+01 5.248238136208966154e+01 2.961767357504439602e+01 2.211321833389409264e+01 1.511463713658741526e+01 1.511463713658741526e+01 1.511463713658741526e+01 3.192268385244501161e+01 3.192268385244501161e+01 4.380182010480866239e+01 2.961767357504439602e+01 2.961767357504439602e+01 2.351307626217090885e+01 1.511463713658741526e+01
2.769076781572628576e+01 4.249321603187907925e+01 7.059349912696190188e+01 8.610807326909532833e+01 8.669469154793776511e+01 6.679333291114897975e+01 5.248238136208966154e+01 2.961767357504439602e+01 1.511463713658741526e+01 1.511463713658741526e+01 2.769076781572628576e+01 4.380182010480866239e+01 5.838232667714368773e+01 5.838232667714368773e+01 5.248238136208966154e+01 5.248238136208966154e+01 2.961767357504439602e+01 2.211321833389409264e+01
2.296635729660084380e+01 4.249321603187907925e+01 6.358707008217353263e+01 7.825640461518052859e+01 9.471059642321327487e+01 7.814414520030800304e+01 5.248238136208966154e+01 3.901874648958862934e+01 2.961767357504439602e+01 2.769076781572628576e+01 4.249321603187907925e+01 5.838232667714368773e+01 7.825640461518052859e+01 8.610807326909532833e+01 7.059349912696190188e+01 5.248238136208966154e+01 2.961767357504439602e+01 2.351307626217090885e+01
2.296635729660084380e+01 3.192268385244501161e+01 5.358140930012572767e+01 7.825640461518052859e+01 9.471059642321327487e+01 9.192906318963123624e+01 7.825640461518052859e+01 5.248238136208966154e+01 4.672142683709009248e+01 4.380182010480866239e+01 5.838232667714368773e+01 7.825640461518052859e+01 8.966038910066768608e+01 9.471059642321327487e+01 8.669469154793776511e+01 6.248552237919630414e+01 3.901874648958862934e+01 2.351307626217090885e+01
1.511463713658741526e+01 2.769076781572628576e+01 5.358140930012572767e+01 7.825640461518052859e+01 9.471059642321327487e+01 1.013056288851884261e+02 9.192906318963123624e+01 7.893911773259438291e+01 6.917298778477487531e+01 6.679333291114897975e+01 7.735689146036698105e+01 8.966038910066768608e+01 1.013056288851884261e+02 1.086775460668524858e+02 9.192906318963123624e+01 6.710196127848456626e+01 4.054524155696034171e+01 2.351307626217090885e+01
1.511463713658741526e+01 2.296635729660084380e+01 4.249321603187907925e+01 5.838232667714368773e+01 7.825640461518052859e+01 9.471059642321327487e+01 1.013056288851884261e+02 9.471059642321327487e+01 9.471059642321327487e+01 8.966038910066768608e+01 9.471059642321327487e+01 1.079504083644616088e+02 1.157490708350802748e+02 1.086775460668524858e+02 9.192906318963123624e+01 6.419706199589880669e+01 3.901874648958862934e+01 2.351307626217090885e+01
1.511463713658741526e+01 1.511463713658741526e+01 2.769076781572628576e+01 4.921443490259468234e+01 6.710196127848456626e+01 7.825640461518052859e+01 9.471059642321327487e+01 1.013056288851884261e+02 9.471059642321327487e+01 1.013056288851884261e+02 1.079504083644616088e+02 1.201134486035831657e+02 1.201134486035831657e+02 1.086775460668524858e+02 9.192906318963123624e+01 6.100683124789392053e+01 4.054524155696034171e+01 2.351307626217090885e+01
1.511463713658741526e+01 1.511463713658741526e+01 2.211321833389409264e+01 3.192268385244501161e+01 4.921443490259468234e+01 5.838232667714368773e+01 7.520171043236922515e+01 7.825640461518052859e+01 9.471059642321327487e+01 9.971339483209079901e+01 1.097331577383123005e+02 1.201134486035831657e+02 1.124628842787825391e+02 1.086775460668524858e+02 8.669469154793776511e+01 5.248238136208966154e+01 3.548927767271133860e+01 2.511114163008871003e+01
1.511463713658741526e+01 1.511463713658741526e+01 1.511463713658741526e+01 2.211321833389409264e+01 2.511114163008871003e+01 4.249321603187907925e+01 5.081958523485921120e+01 5.838232667714368773e+01 7.059349912696190188e+01 7.825640461518052859e+01 1.013056288851884261e+02 1.097331577383123005e+02 1.124628842787825391e+02 9.948074772570672053e+01 7.730779225399004417e+01 5.248238136208966154e+01 3.066804902402449429e+01 1.511463713658741526e+01
1.190524465010934740e+01 1.511463713658741526e+01 1.511463713658741526e+01 1.511463713658741526e+01 2.211321833389409264e+01 2.211321833389409264e+01 2.511114163008871003e+01 4.249321603187907925e+01 5.081958523485921120e+01 6.710196127848456626e+01 8.473473783412289606e+01 1.013056288851884261e+02 1.124628842787825391e+02 9.192906318963123624e+01 7.059349912696190188e+01 4.054524155696034171e+01 2.511114163008871003e+01 1.511463713658741526e+01
1.190524465010934740e+01 1.190524465010934740e+01 1.511463713658741526e+01 1.511463713658741526e+01 1.511463713658741526e+01 1.511463713658741526e+01 2.211321833389409264e+01 2.296635729660084380e+01 3.192268385244501161e+01 5.358140930012572767e+01 7.825640461518052859e+01 1.013056288851884261e+02 1.086775460668524858e+02 9.192906318963123624e+01 6.710196127848456626e+01 4.054524155696034171e+01 2.351307626217090885e+01 1.511463713658741526e+01
1.190524465010934740e+01 1.190524465010934740e+01 1.190524465010934740e+01 1.190524465010934740e+01 1.511463713658741526e+01 1.511463713658741526e+01 1.511463713658741526e+01 2.296635729660084380e+01 3.192268385244501161e+01 5.838232667714368773e+01 8.610807326909532833e+01 9.471059642321327487e+01 9.948074772570672053e+01 8.669469154793776511e+01 6.100683124789392053e+01 4.054524155696034171e+01 2.351307626217090885e+01 1.511463713658741526e+01
1.190524465010934740e+01 1.190524465010934740e+01 1.190524465010934740e+01 1.190524465010934740e+01 1.190524465010934740e+01 1.511463713658741526e+01 1.511463713658741526e+01 2.769076781572628576e+01 4.148888613914239443e+01 6.358707008217353263e+01 8.610807326909532833e+01 1.013056288851884261e+02 9.192906318963123624e+01 7.520171043236922515e+01 5.248238136208966154e+01 3.066804902402449429e+01 2.511114163008871003e+01 1.511463713658741526e+01
1.190524465010934740e+01 1.190524465010934740e+01 1.190524465010934740e+01 1.190524465010934740e+01 1.511463713658741526e+01 1.511463713658741526e+01 2.296635729660084380e+01 3.192268385244501161e+01 5.838232667714368773e+01 7.735689146036698105e+01 9.471059642321327487e+01 9.192906318963123624e+01 8.669469154793776511e+01 6.225292056077218206e+01 4.054524155696034171e+01 2.511114163008871003e+01 1.511463713658741526e+01 1.511463713658741526e+01
1.190524465010934740e+01 1.190524465010934740e+01 1.190524465010934740e+01 1.511463713658741526e+01 1.511463713658741526e+01 2.296635729660084380e+01 3.192268385244501161e+01 4.921443490259468234e+01 6.917298778477487531e+01 8.610807326909532833e+01 9.471059642321327487e+01 9.192906318963123624e+01 7.825640461518052859e+01 5.248238136208966154e+01 3.066804902402449429e+01 1.511463713658741526e+01 1.511463713658741526e+01 1.190524465010934740e+01
1.190524465010934740e+01 1.190524465010934740e+01 1.190524465010934740e+01 1.511463713658741526e+01 1.511463713658741526e+01 2.769076781572628576e+01 4.380182010480866239e+01 5.838232667714368773e+01 7.825640461518052859e+01 9.471059642321327487e+01 8.669469154793776511e+01 7.814414520030800304e+01 5.979650595327504448e+01 3.548927767271133860e+01 2.511114163008871003e+01 1.511463713658741526e+01 1.511463713658741526e+01 1.190524465010934740e+01
