1.111026945965503643e+01 1.111026945965503643e+01 1.111026945965503643e+01 1.426899006704594974e+01 2.349465585384244193e+01 2.663995030969338274e+01 3.499031030344925597e+01 3.819476928171307861e+01 4.031875041940826065e+01 4.267909663341956161e+01 4.474724024333298189e+01 4.474724024333298189e+01 4.267909663341956161e+01 4.031875041940826065e+01 3.387519632955396531e+01 2.615584270645266329e+01
1.111026945965503643e+01 1.111026945965503643e+01 1.426899006704594974e+01 2.349465585384244193e+01 2.663995030969338274e+01 3.663255264227217367e+01 4.059403030794769762e+01 4.777738597299682510e+01 4.607017376874588876e+01 4.607017376874588876e+01 4.607017376874588876e+01 4.626653665648613156e+01 4.607017376874588876e+01 4.607017376874588876e+01 3.816437172685977686e+01 3.223737318736920798e+01
1.111026945965503643e+01 1.426899006704594974e+01 2.116719651383462519e+01 2.663995030969338274e+01 3.663255264227217367e+01 4.059403030794769762e+01 4.626653665648613156e+01 5.024109142379817428e+01 4.676850585505312097e+01 4.676850585505312097e+01 4.676850585505312097e+01 4.676850585505312097e+01 5.168351030594526208e+01 5.024109142379817428e+01 4.323861961583910585e+01 3.796822476687520265e+01
1.111026945965503643e+01 1.898505341904900945e+01 2.491567012979014351e+01 3.517455013483374415e+01 4.396893141451906217e+01 5.057085802765806903e+01 4.764344775533621856e+01 4.879885470424969185e+01 4.261245503382568245e+01 4.045767434373495064e+01 4.211451393161243573e+01 4.569407478267318368e+01 5.168351030594526208e+01 5.024109142379817428e+01 4.323861961583910585e+01 3.554246170284243789e+01
1.321014241603691630e+01 2.116719651383462519e+01 2.819840871650341185e+01 3.955804392878566489e+01 5.168351030594526208e+01 5.458707983645785333e+01 5.158337512239651090e+01 4.323861961583910585e+01 4.045767434373495064e+01 4.045767434373495064e+01 4.626653665648613156e+01 4.626653665648613156e+01 5.168351030594526208e+01 4.879885470424969185e+01 4.323861961583910585e+01 3.303732843661452989e+01
1.321014241603691630e+01 2.332552522559570463e+01 3.429386876906858106e+01 4.291902378293908527e+01 5.696748945297107269e+01 5.807376869099235961e+01 5.109611416813753237e+01 4.764344775533621856e+01 4.267909663341956161e+01 4.474724024333298189e+01 4.777738597299682510e+01 5.144137014968008259e+01 5.024109142379817428e+01 4.323861961583910585e+01 3.643712075586672938e+01 2.784480206693855209e+01
1.426899006704594974e+01 2.506149323593346878e+01 3.171625398459580936e+01 4.291902378293908527e+01 5.696748945297107269e+01 5.987829605194019678e+01 5.321683453418690135e+01 5.109611416813753237e+01 4.845400598731942665e+01 5.144137014968008259e+01 5.935447029428890886e+01 5.458707983645785333e+01 5.158337512239651090e+01 4.323861961583910585e+01 3.336648916956850996e+01 2.465904525361333910e+01
1.321014241603691630e+01 2.506149323593346878e+01 3.171625398459580936e+01 4.197203732254644848e+01 5.168351030594526208e+01 5.987829605194019678e+01 6.022627802871780744e+01 5.807376869099235961e+01 5.885479201012011430e+01 5.935447029428890886e+01 6.303074957384670540e+01 6.022627802871780744e+01 4.915901344910859905e+01 3.725303777605445532e+01 2.840094802571573140e+01 2.077377449729176817e+01
1.321014241603691630e+01 2.116719651383462519e+01 2.901667924916008090e+01 4.134960931786033456e+01 5.486001585409254488e+01 5.987829605194019678e+01 5.987829605194019678e+01 6.544758129311962591e+01 6.427300638529676746e+01 6.796123670543668993e+01 6.441583911464573475e+01 5.860150517909050905e+01 4.465046363519414285e+01 3.093057937346662101e+01 2.131008280514686248e+01 1.111026945965503643e+01
1.111026945965503643e+01 1.321014241603691630e+01 2.620090473977418810e+01 3.241083835881519803e+01 4.211451393161243573e+01 5.050880583800793033e+01 5.742312915911143989e+01 6.544758129311962591e+01 6.903110613368069437e+01 6.701923069366466734e+01 6.056538830489850511e+01 4.910701475352371403e+01 3.725303777605445532e+01 2.465904525361333910e+01 2.099632535233447328e+01 1.111026945965503643e+01
1.111026945965503643e+01 1.321014241603691630e+01 2.116719651383462519e+01 2.683136893053819350e+01 3.402163178263875665e+01 4.211451393161243573e+01 5.486001585409254488e+01 6.269019858966967718e+01 6.701923069366466734e+01 6.510682440927914172e+01 5.690243427649569696e+01 4.465046363519414285e+01 3.093057937346662101e+01 2.131008280514686248e+01 1.111026945965503643e+01 1.111026945965503643e+01
1.111026945965503643e+01 1.111026945965503643e+01 1.321014241603691630e+01 2.116719651383462519e+01 2.683136893053819350e+01 3.930389493642775989e+01 5.332176293409451517e+01 6.269019858966967718e+01 5.987829605194019678e+01 5.690243427649569696e+01 4.465046363519414285e+01 3.303732843661452989e+01 2.465904525361333910e+01 2.077377449729176817e+01 1.111026945965503643e+01 1.111026945965503643e+01
1.111026945965503643e+01 1.111026945965503643e+01 1.321014241603691630e+01 2.116719651383462519e+01 2.724138639992638034e+01 3.930389493642775989e+01 4.792880441506426337e+01 5.987829605194019678e+01 5.690243427649569696e+01 4.915901344910859905e+01 3.725303777605445532e+01 2.840094802571573140e+01 2.099632535233447328e+01 1.111026945965503643e+01 1.111026945965503643e+01 1.111026945965503643e+01
1.111026945965503643e+01 1.111026945965503643e+01 1.898505341904900945e+01 2.310746408237597294e+01 3.212373693199725722e+01 4.434603800228275361e+01 5.168351030594526208e+01 5.024109142379817428e+01 4.879885470424969185e+01 4.250024866587941119e+01 3.093057937346662101e+01 2.099632535233447328e+01 1.633005192814725604e+01 1.426899006704594974e+01 1.426899006704594974e+01 1.111026945965503643e+01
1.111026945965503643e+01 1.111026945965503643e+01 2.116719651383462519e+01 2.819840871650341185e+01 3.756834063179907446e+01 4.792880441506426337e+01 5.168351030594526208e+01 5.158337512239651090e+01 4.323861961583910585e+01 3.093057937346662101e+01 2.417656032152509127e+01 1.633005192814725604e+01 1.426899006704594974e+01 1.898505341904900945e+01 2.004227066761244203e+01 1.426899006704594974e+01
1.111026945965503643e+01 1.898505341904900945e+01 2.332552522559570463e+01 3.333903576947874825e+01 4.059403030794769762e+01 4.569407478267318368e+01 4.879885470424969185e+01 4.261245503382568245e+01 3.725303777605445532e+01 2.465904525361333910e+01 2.099632535233447328e+01 1.633005192814725604e+01 1.898505341904900945e+01 2.148802753317532321e+01 2.148802753317532321e+01 2.262311694500834847e+01
