1.469586850582511595e+01 1.469586850582511595e+01 1.469586850582511595e+01 1.469586850582511595e+01 1.469586850582511595e+01 2.279084376656084743e+01 2.279084376656084743e+01 3.274518976078169885e+01 4.308274675113928964e+01 4.983822368743089015e+01 5.449179102600994895e+01 5.449179102600994895e+01 5.449179102600994895e+01 5.449179102600994895e+01 5.673037057345660372e+01 5.887476323717615401e+01
1.469586850582511595e+01 1.469586850582511595e+01 1.469586850582511595e+01 1.469586850582511595e+01 2.279084376656084743e+01 2.399895667318427783e+01 3.379669219798658020e+01 4.427287430920635813e+01 5.585460818410743400e+01 6.469882356996129147e+01 6.469882356996129147e+01 6.545471466063165167e+01 6.545471466063165167e+01 6.545471466063165167e+01 6.469882356996129147e+01 6.702284393935883600e+01
1.469586850582511595e+01 1.469586850582511595e+01 1.469586850582511595e+01 1.469586850582511595e+01 2.205986361929080175e+01 2.954726895073697079e+01 4.040998488337644545e+01 5.360020713096480449e+01 6.681938133919430811e+01 7.283381291685175540e+01 7.283381291685175540e+01 6.702284393935883600e+01 6.702284393935883600e+01 6.507795702258502502e+01 6.507795702258502502e+01 6.431902135184276403e+01
1.469586850582511595e+01 1.469586850582511595e+01 1.469586850582511595e+01 2.279084376656084743e+01 2.954726895073697079e+01 3.828332811748287412e+01 4.545178437833624940e+01 5.786920961544829822e+01 6.507795702258502502e+01 6.507795702258502502e+01 6.507795702258502502e+01 6.431902135184276403e+01 5.618417388037495641e+01 5.113838725190433365e+01 5.038490659692121199e+01 4.823411601895421086e+01
1.469586850582511595e+01 1.469586850582511595e+01 1.469586850582511595e+01 2.399895667318427783e+01 3.562784492286215965e+01 4.545178437833624940e+01 5.545611783448738663e+01 5.113838725190433365e+01 5.113838725190433365e+01 5.113838725190433365e+01 5.038490659692121199e+01 4.823411601895421086e+01 3.921325040625543323e+01 3.921325040625543323e+01 3.629940760447554027e+01 3.431961947647582178e+01
1.469586850582511595e+01 1.469586850582511595e+01 2.205986361929080175e+01 3.126493123386738660e+01 4.427287430920635813e+01 5.545611783448738663e+01 6.874582310174146471e+01 5.277684220550771954e+01 4.796950589069371063e+01 3.921325040625543323e+01 3.323135140572374979e+01 3.344678142888719208e+01 3.201372137274567820e+01 2.462362243224844605e+01 2.139840636446014699e+01 2.139840636446014699e+01
1.469586850582511595e+01 1.469586850582511595e+01 2.954726895073697079e+01 3.828332811748287412e+01 5.360020713096480449e+01 6.681938133919430811e+01 6.431902135184276403e+01 5.277684220550771954e+01 4.146048177561450387e+01 3.090074613076385290e+01 2.139840636446014699e+01 2.139840636446014699e+01 1.469586850582511595e+01 1.469586850582511595e+01 1.469586850582511595e+01 1.469586850582511595e+01
1.469586850582511595e+01 2.279084376656084743e+01 2.954726895073697079e+01 4.200239028648438477e+01 5.786920961544829822e+01 6.984338266879555590e+01 6.431902135184276403e+01 5.277684220550771954e+01 3.724338701329737233e+01 2.185499586684433027e+01 1.469586850582511595e+01 1.469586850582511595e+01 1.469586850582511595e+01 1.469586850582511595e+01 1.469586850582511595e+01 1.469586850582511595e+01
1.469586850582511595e+01 1.469586850582511595e+01 2.609233891357333945e+01 4.200239028648438477e+01 5.786920961544829822e+01 6.507795702258502502e+01 6.431902135184276403e+01 4.796950589069371063e+01 3.724338701329737233e+01 2.185499586684433027e+01 1.469586850582511595e+01 1.469586850582511595e+01 1.469586850582511595e+01 1.469586850582511595e+01 1.469586850582511595e+01 1.469586850582511595e+01
1.469586850582511595e+01 1.469586850582511595e+01 2.609233891357333945e+01 4.170066305612757418e+01 5.734867352226623893e+01 6.507795702258502502e+01 5.618417388037495641e+01 4.796950589069371063e+01 3.090074613076385290e+01 2.185499586684433027e+01 1.469586850582511595e+01 1.469586850582511595e+01 1.469586850582511595e+01 1.469586850582511595e+01 1.469586850582511595e+01 1.469586850582511595e+01
1.469586850582511595e+01 1.469586850582511595e+01 2.609233891357333945e+01 3.413152673006452176e+01 4.725540117473100565e+01 5.113838725190433365e+01 5.113838725190433365e+01 4.146048177561450387e+01 3.090074613076385290e+01 2.185499586684433027e+01 1.469586850582511595e+01 1.469586850582511595e+01 1.469586850582511595e+01 1.469586850582511595e+01 1.469586850582511595e+01 1.469586850582511595e+01
1.469586850582511595e+01 2.114438536666791535e+01 2.609233891357333945e+01 2.687398966409574541e+01 3.762968752695125119e+01 3.762968752695125119e+01 3.762968752695125119e+01 3.701409251117517840e+01 3.090074613076385290e+01 2.462362243224844605e+01 2.185499586684433027e+01 1.469586850582511595e+01 1.469586850582511595e+01 1.469586850582511595e+01 1.469586850582511595e+01 1.469586850582511595e+01
2.279084376656084743e+01 2.114438536666791535e+01 2.114438536666791535e+01 2.687398966409574541e+01 3.016671120903355785e+01 3.762968752695125119e+01 3.329460849837486336e+01 3.551470049834200893e+01 3.090074613076385290e+01 2.462362243224844605e+01 2.185499586684433027e+01 1.469586850582511595e+01 1.469586850582511595e+01 1.469586850582511595e+01 1.469586850582511595e+01 1.469586850582511595e+01
2.279084376656084743e+01 2.114438536666791535e+01 2.279084376656084743e+01 3.329460849837486336e+01 3.515976866548723478e+01 4.308274675113928964e+01 4.676348413381428060e+01 3.551470049834200893e+01 3.103033747808384746e+01 2.462362243224844605e+01 2.185499586684433027e+01 1.469586850582511595e+01 1.469586850582511595e+01 1.469586850582511595e+01 1.469586850582511595e+01 1.469586850582511595e+01
3.274518976078169885e+01 3.329460849837486336e+01 3.329460849837486336e+01 4.308274675113928964e+01 4.983822368743089015e+01 5.308440151394835027e+01 5.331234618823938121e+01 4.110452070860131357e+01 3.458549671916401991e+01 2.462362243224844605e+01 2.185499586684433027e+01 1.469586850582511595e+01 1.469586850582511595e+01 1.469586850582511595e+01 1.469586850582511595e+01 1.469586850582511595e+01
3.828332811748287412e+01 4.308274675113928964e+01 5.449179102600994895e+01 5.308440151394835027e+01 5.887476323717615401e+01 6.469882356996129147e+01 5.331234618823938121e+01 4.796950589069371063e+01 3.724338701329737233e+01 2.185499586684433027e+01 2.185499586684433027e+01 1.469586850582511595e+01 1.469586850582511595e+01 1.469586850582511595e+01 1.469586850582511595e+01 1.469586850582511595e+01
