1.120968340968828869e+01 1.429494892153983621e+01 1.947274644289167256e+01 2.730534121805127867e+01 3.904067844304402257e+01 5.232191484515422530e+01 6.104654904158404349e+01 6.472010033452747280e+01 6.653775986831483635e+01 6.483025015261611657e+01 6.131029046153504680e+01 5.368239308466425541e+01 4.110606386449958194e+01 3.387519632955396531e+01 2.316955802744011805e+01 2.022561566204207395e+01
1.120968340968828869e+01 1.429494892153983621e+01 2.310746408237597294e+01 3.330666987062260631e+01 4.583701393240018263e+01 5.817892563047020360e+01 6.427300638529676746e+01 6.839354945423924903e+01 6.701923069366466734e+01 6.839354945423924903e+01 6.796123670543668993e+01 6.167008920251516457e+01 5.501011736653533291e+01 4.110606386449958194e+01 3.223737318736920798e+01 2.022561566204207395e+01
1.120968340968828869e+01 1.947274644289167256e+01 2.607007481383637781e+01 3.829105975832790421e+01 5.195647100785615180e+01 6.633793510216524680e+01 6.701923069366466734e+01 6.701923069366466734e+01 6.730198551164198761e+01 6.701923069366466734e+01 7.138171780632447394e+01 7.054637084629571575e+01 6.404328155434440362e+01 4.869608447649896732e+01 3.223737318736920798e+01 2.130879320207380800e+01
1.323600567023050445e+01 1.947274644289167256e+01 2.607007481383637781e+01 3.682463887729717555e+01 5.332176293409451517e+01 6.409977116104170136e+01 6.441583911464573475e+01 6.441583911464573475e+01 6.544758129311962591e+01 6.903110613368069437e+01 6.903110613368069437e+01 7.290488441584986390e+01 6.512118178813553016e+01 4.891684207808356888e+01 3.303732843661452989e+01 2.130879320207380800e+01
1.323600567023050445e+01 1.947274644289167256e+01 2.506149323593346878e+01 3.682463887729717555e+01 5.332176293409451517e+01 6.269019858966967718e+01 6.903110613368069437e+01 6.796123670543668993e+01 6.716440089801541546e+01 6.903110613368069437e+01 6.839354945423924903e+01 6.512118178813553016e+01 5.511672983615929411e+01 4.465046363519414285e+01 2.971170697113958781e+01 2.130879320207380800e+01
1.120968340968828869e+01 1.323600567023050445e+01 2.506149323593346878e+01 3.682463887729717555e+01 5.332176293409451517e+01 6.082882422064118089e+01 6.903110613368069437e+01 7.219542913583492805e+01 7.279666477671928249e+01 7.279666477671928249e+01 6.839354945423924903e+01 6.095966986117294795e+01 4.910701475352371403e+01 3.725303777605445532e+01 2.499610228114664068e+01 1.552915143469894943e+01
1.120968340968828869e+01 1.323600567023050445e+01 2.208284346697459810e+01 2.908378233055177375e+01 4.588278330602000210e+01 6.082882422064118089e+01 7.012131246803079421e+01 7.880104355841972108e+01 7.976877197151814869e+01 7.371230562276525689e+01 6.512118178813553016e+01 5.511672983615929411e+01 4.183004665625949769e+01 3.093057937346662101e+01 2.130879320207380800e+01 1.120968340968828869e+01
1.120968340968828869e+01 1.323600567023050445e+01 1.947274644289167256e+01 2.620090473977418810e+01 4.134960931786033456e+01 5.332176293409451517e+01 7.012131246803079421e+01 8.194285626802944478e+01 8.654891808184441970e+01 7.740981002389828802e+01 6.886118292093891569e+01 4.891684207808356888e+01 3.697250606461294353e+01 2.448596261809960595e+01 1.552915143469894943e+01 1.120968340968828869e+01
1.120968340968828869e+01 1.120968340968828869e+01 1.429494892153983621e+01 2.506149323593346878e+01 3.682463887729717555e+01 5.214755761632261510e+01 6.808669875355538181e+01 8.194285626802944478e+01 8.284488346562066852e+01 8.085219837404822840e+01 5.918648535261171162e+01 4.802721591534514545e+01 3.355880652559244481e+01 2.130879320207380800e+01 1.120968340968828869e+01 1.120968340968828869e+01
1.120968340968828869e+01 1.120968340968828869e+01 1.323600567023050445e+01 2.325010376104999921e+01 3.430347533254374781e+01 5.214755761632261510e+01 6.808669875355538181e+01 8.194285626802944478e+01 8.284488346562066852e+01 7.740981002389828802e+01 6.880068536295557635e+01 4.802721591534514545e+01 3.223737318736920798e+01 2.022561566204207395e+01 1.120968340968828869e+01 1.120968340968828869e+01
1.120968340968828869e+01 1.120968340968828869e+01 1.429494892153983621e+01 2.325010376104999921e+01 3.430347533254374781e+01 5.017267496025729656e+01 6.478662602378409474e+01 7.844902607179642473e+01 7.928738637638328157e+01 7.394623335271946019e+01 6.886118292093891569e+01 5.297369625067973686e+01 3.645589184043345909e+01 2.316955802744011805e+01 1.120968340968828869e+01 1.120968340968828869e+01
1.120968340968828869e+01 1.120968340968828869e+01 1.947274644289167256e+01 2.310746408237597294e+01 3.682463887729717555e+01 5.017267496025729656e+01 6.082882422064118089e+01 6.701923069366466734e+01 7.600099241172841857e+01 7.070913606626830017e+01 6.512118178813553016e+01 5.409270382038431535e+01 3.796822476687520265e+01 2.615584270645266329e+01 2.022561566204207395e+01 1.120968340968828869e+01
1.120968340968828869e+01 1.323600567023050445e+01 1.947274644289167256e+01 2.712711440214687642e+01 3.829105975832790421e+01 4.792880441506426337e+01 5.585325394206384431e+01 6.701923069366466734e+01 6.701923069366466734e+01 6.730198551164198761e+01 6.022627802871780744e+01 5.320300699419177448e+01 4.327751834359249727e+01 3.223737318736920798e+01 2.022561566204207395e+01 1.120968340968828869e+01
1.120968340968828869e+01 1.323600567023050445e+01 1.947274644289167256e+01 2.949235039376378609e+01 3.829105975832790421e+01 4.994266520565625456e+01 5.698938433445925966e+01 5.987829605194019678e+01 5.987829605194019678e+01 5.987829605194019678e+01 6.022627802871780744e+01 5.320300699419177448e+01 4.327751834359249727e+01 3.223737318736920798e+01 2.130879320207380800e+01 1.120968340968828869e+01
1.120968340968828869e+01 1.323600567023050445e+01 2.116719651383462519e+01 2.949235039376378609e+01 4.196149954405445470e+01 5.496445167320184311e+01 5.736196624070641548e+01 5.928854244277604835e+01 5.880698310067301549e+01 5.946931426397100040e+01 6.022627802871780744e+01 5.320300699419177448e+01 4.327751834359249727e+01 2.784480206693855209e+01 2.130879320207380800e+01 1.120968340968828869e+01
1.120968340968828869e+01 1.323600567023050445e+01 2.310746408237597294e+01 3.430347533254374781e+01 4.437187999062885524e+01 5.496445167320184311e+01 6.303074957384670540e+01 6.167008920251516457e+01 6.131029046153504680e+01 5.928854244277604835e+01 5.635277320690749292e+01 5.126831579142742612e+01 3.948470801576380751e+01 2.784480206693855209e+01 2.022561566204207395e+01 1.120968340968828869e+01
