1.124463652547618864e+01 1.965378094741278403e+01 2.748319582419226492e+01 3.867239831996459998e+01 5.136128184119382922e+01 6.353212631728373339e+01 7.234457042065032795e+01 7.392315983043552308e+01 7.392315983043552308e+01 7.853061109554005270e+01 7.863862612059175206e+01 7.279666477671928249e+01 7.271542750423630252e+01 5.860150517909050905e+01 4.891872542549638325e+01 3.600597215993245470e+01
1.429075348371232757e+01 2.331527759367284247e+01 3.469575454380431978e+01 4.928807791524910442e+01 6.366448746227678868e+01 8.070919396789952316e+01 8.500805693559770759e+01 8.847320298770272018e+01 8.847320298770272018e+01 8.058135902217482283e+01 7.600099241172841857e+01 7.568865864918666375e+01 6.725783941074605821e+01 5.690243427649569696e+01 4.393030427399274629e+01 3.303732843661452989e+01
1.965378094741278403e+01 2.505011617452640849e+01 4.053536170482573198e+01 5.949540052058331696e+01 8.037623974439146934e+01 8.891632129005765250e+01 9.173730677197318073e+01 8.925295871655478663e+01 8.473305956977100095e+01 7.932237900884217652e+01 7.182700724876319498e+01 6.177097305569189700e+01 5.241538549107528411e+01 4.490889113614305472e+01 3.597684941991794716e+01 2.499610228114664068e+01
1.965378094741278403e+01 2.990195869095384040e+01 4.928807791524910442e+01 6.681233267346206617e+01 8.177439966418575068e+01 9.262543256769893674e+01 8.925295871655478663e+01 8.473305956977100095e+01 7.568865864918666375e+01 6.725783941074605821e+01 6.039402289695163262e+01 5.253099878029688341e+01 4.182865475898466201e+01 3.597684941991794716e+01 2.499610228114664068e+01 1.864542951757901790e+01
2.331527759367284247e+01 3.682463887729717555e+01 5.352065712595401692e+01 7.687652808644639890e+01 8.891632129005765250e+01 8.950001426183381170e+01 8.587171378764600149e+01 7.758381343425510579e+01 6.817350067556657223e+01 6.404328155434440362e+01 5.320300699419177448e+01 4.326489827986792136e+01 3.643712075586672938e+01 2.750982112280787106e+01 1.864542951757901790e+01 1.864542951757901790e+01
2.347216435505650978e+01 3.682463887729717555e+01 5.352065712595401692e+01 7.687652808644639890e+01 9.016860573274254875e+01 8.950001426183381170e+01 8.847320298770272018e+01 8.331944065126251076e+01 7.939894316470135038e+01 6.771855812310811018e+01 5.435800331957737086e+01 4.847689613368719819e+01 3.545310400551402097e+01 2.658112996698412900e+01 2.022561566204207395e+01 1.124463652547618864e+01
2.347216435505650978e+01 3.711038315858495906e+01 5.742312915911143989e+01 7.687652808644639890e+01 9.120004229641762095e+01 9.440255257063205363e+01 8.950001426183381170e+01 8.950001426183381170e+01 8.331944065126251076e+01 7.939894316470135038e+01 6.771855812310811018e+01 5.501011736653533291e+01 4.110606386449958194e+01 3.387519632955396531e+01 2.389638340892654256e+01 2.022561566204207395e+01
2.331527759367284247e+01 3.711038315858495906e+01 4.991833210241719598e+01 7.025175830159983548e+01 8.354818944602928354e+01 9.120004229641762095e+01 8.925295871655478663e+01 8.950001426183381170e+01 8.950001426183381170e+01 8.058135902217482283e+01 7.410391588035162158e+01 6.487608760481936088e+01 5.368047336539958536e+01 3.891575055333792221e+01 3.224572975192074864e+01 2.022561566204207395e+01
1.900148538677041188e+01 2.949235039376378609e+01 4.208725287420060823e+01 5.742312915911143989e+01 7.083210424379701919e+01 7.913341340603338381e+01 8.473305956977100095e+01 7.932237900884217652e+01 7.913341340603338381e+01 7.421703243256391147e+01 7.769991012273925435e+01 6.881346674017314058e+01 6.487608760481936088e+01 4.847689613368719819e+01 4.110606386449958194e+01 2.739503214944988940e+01
1.554028508783400397e+01 2.405016311689978181e+01 3.383159300134894210e+01 4.863171841436514597e+01 5.303105443996843604e+01 6.280915408616499462e+01 6.177097305569189700e+01 6.177097305569189700e+01 6.177097305569189700e+01 6.280915408616499462e+01 6.372627608658368814e+01 6.730198551164198761e+01 6.464671052727197775e+01 5.880698310067301549e+01 4.847689613368719819e+01 3.224572975192074864e+01
1.124463652547618864e+01 1.900148538677041188e+01 2.405016311689978181e+01 3.588099035036967877e+01 4.118125071076553922e+01 4.118125071076553922e+01 3.921325040625543323e+01 4.118125071076553922e+01 4.118125071076553922e+01 4.863171841436514597e+01 4.939607452336669269e+01 5.654354298264153300e+01 6.730198551164198761e+01 6.404328155434440362e+01 5.435800331957737086e+01 3.834679002982301910e+01
1.124463652547618864e+01 1.429075348371232757e+01 2.075604345287935004e+01 2.208284346697459810e+01 3.293509973817581482e+01 3.293509973817581482e+01 3.273746360764900487e+01 3.273746360764900487e+01 3.240649840439640883e+01 3.402163178263875665e+01 4.208725287420060823e+01 5.331510558107278541e+01 6.301877351097579805e+01 6.167008920251516457e+01 5.409270382038431535e+01 4.019659863314314663e+01
1.124463652547618864e+01 1.429075348371232757e+01 1.965378094741278403e+01 2.259972498557032239e+01 2.651513625981647948e+01 3.037785334168517437e+01 3.037785334168517437e+01 2.436968423419864749e+01 2.651513625981647948e+01 3.211772120449354873e+01 4.201082488406358806e+01 5.496445167320184311e+01 6.394326933586863504e+01 6.655151067431171441e+01 5.918648535261171162e+01 4.461902824681548907e+01
1.124463652547618864e+01 1.965378094741278403e+01 2.663995030969338274e+01 3.121580730752296873e+01 3.499031030344925597e+01 4.447632290091978291e+01 3.582962768778943285e+01 3.387519632955396531e+01 2.911788083380110947e+01 3.499031030344925597e+01 4.583701393240018263e+01 5.817892563047020360e+01 6.831335806737722294e+01 7.279666477671928249e+01 5.860150517909050905e+01 4.563964877958628108e+01
1.429075348371232757e+01 2.331527759367284247e+01 3.393780230930418895e+01 4.388118591809917746e+01 5.450846572890946362e+01 5.450846572890946362e+01 5.283770823731391886e+01 4.682157958290817135e+01 4.447632290091978291e+01 4.842146045077520711e+01 5.801021474124175370e+01 6.779130232097466546e+01 7.506617646251649489e+01 7.193729886938004370e+01 5.860150517909050905e+01 4.054113073728782979e+01
1.429075348371232757e+01 2.331527759367284247e+01 3.941723428563511789e+01 5.517062156126188199e+01 6.366448746227678868e+01 7.392315983043552308e+01 7.392315983043552308e+01 6.771855812310811018e+01 6.230044950506459855e+01 6.353212631728373339e+01 7.262321705740640709e+01 7.506617646251649489e+01 7.758381343425510579e+01 7.007607721432493975e+01 5.285911979362916213e+01 3.697250606461294353e+01
