1.131742761318360913e+01 1.131742761318360913e+01 1.131742761318360913e+01 1.934136985729708158e+01 2.821994135735824827e+01 4.053536170482573198e+01 5.753370946085185977e+01 7.078046841567282854e+01 7.758381343425510579e+01 6.500214338683397841e+01 5.282000234207117018e+01 3.443377570436271640e+01 2.239089908312269017e+01 1.131742761318360913e+01 1.131742761318360913e+01 1.131742761318360913e+01
1.131742761318360913e+01 1.131742761318360913e+01 1.431902873562441769e+01 2.145702899588592061e+01 3.051819519930133140e+01 4.599278891250801848e+01 6.681233267346206617e+01 7.712261886807795008e+01 7.758381343425510579e+01 6.886118292093891569e+01 4.825478174496291217e+01 3.443377570436271640e+01 2.239089908312269017e+01 1.131742761318360913e+01 1.131742761318360913e+01 1.131742761318360913e+01
1.131742761318360913e+01 1.131742761318360913e+01 1.707770394957298166e+01 2.346729735679002360e+01 3.664780443866340676e+01 5.352778481809706079e+01 6.937318638045923080e+01 8.226593914949606301e+01 8.085219837404822840e+01 6.475750524934274210e+01 4.563964877958628108e+01 2.995560045713644470e+01 2.023443756438420849e+01 1.131742761318360913e+01 1.131742761318360913e+01 1.131742761318360913e+01
1.131742761318360913e+01 1.131742761318360913e+01 1.934136985729708158e+01 2.491812982698525403e+01 4.053536170482573198e+01 6.009682429519476443e+01 7.687652808644639890e+01 8.749902820080302490e+01 8.003803139272154965e+01 6.800989171950672585e+01 5.282000234207117018e+01 3.443377570436271640e+01 2.239089908312269017e+01 1.131742761318360913e+01 1.131742761318360913e+01 1.131742761318360913e+01
1.131742761318360913e+01 1.431902873562441769e+01 2.145702899588592061e+01 3.051819519930133140e+01 4.599278891250801848e+01 6.681233267346206617e+01 8.512718846493777392e+01 9.307751343015635825e+01 9.562155704412899127e+01 7.691298104223922394e+01 5.918648535261171162e+01 3.646045112751802719e+01 2.388344411794721367e+01 2.023443756438420849e+01 1.131742761318360913e+01 1.131742761318360913e+01
1.131742761318360913e+01 1.431902873562441769e+01 2.332552522559570463e+01 3.664780443866340676e+01 5.352778481809706079e+01 7.611211540885670956e+01 9.212339860916077328e+01 1.051461585444770321e+02 9.782500201837616771e+01 8.537028255888111516e+01 6.481409894843383768e+01 4.356657898909884352e+01 3.224572975192074864e+01 2.023443756438420849e+01 1.131742761318360913e+01 1.131742761318360913e+01
1.131742761318360913e+01 1.707770394957298166e+01 2.491812982698525403e+01 3.682792426107506856e+01 5.904697954214974231e+01 8.274113025642870412e+01 9.987159153155968738e+01 1.099221332023580544e+02 1.037596037268596945e+02 9.782500201837616771e+01 7.691298104223922394e+01 5.918648535261171162e+01 4.110606386449958194e+01 2.634356179176718271e+01 2.023443756438420849e+01 1.131742761318360913e+01
1.131742761318360913e+01 1.900467287786091575e+01 2.876044561321843318e+01 4.244304352106584588e+01 6.681233267346206617e+01 8.274113025642870412e+01 9.987159153155968738e+01 1.108291441830825619e+02 1.076180396467835152e+02 1.002204825941503685e+02 8.655346914613808451e+01 6.481409894843383768e+01 5.282000234207117018e+01 3.463127514738047807e+01 2.023443756438420849e+01 1.131742761318360913e+01
1.431902873562441769e+01 2.145702899588592061e+01 3.051819519930133140e+01 4.583701393240018263e+01 6.681233267346206617e+01 8.354818944602928354e+01 9.987159153155968738e+01 1.016246157608253924e+02 1.016246157608253924e+02 1.002204825941503685e+02 8.761103294201436142e+01 7.691298104223922394e+01 5.282000234207117018e+01 3.463127514738047807e+01 2.239089908312269017e+01 1.131742761318360913e+01
1.431902873562441769e+01 2.260654786537268635e+01 3.520856440742045379e+01 5.013975682355902563e+01 6.937318638045923080e+01 8.354818944602928354e+01 8.824415927825495487e+01 9.225002602728844181e+01 8.939972615873192296e+01 9.440255257063205363e+01 8.935191233432462354e+01 7.557860543072955295e+01 5.912753418509537795e+01 3.718277572296367595e+01 2.239089908312269017e+01 1.131742761318360913e+01
1.431902873562441769e+01 2.346729735679002360e+01 3.682792426107506856e+01 5.214755761632261510e+01 6.937318638045923080e+01 8.193324306583735961e+01 8.427297332358722315e+01 8.056278935237567396e+01 8.939972615873192296e+01 9.121247724687289349e+01 8.587171378764600149e+01 7.557860543072955295e+01 5.912753418509537795e+01 3.702539048413556344e+01 2.239089908312269017e+01 1.131742761318360913e+01
1.431902873562441769e+01 2.346729735679002360e+01 3.710558741233958813e+01 5.531892856036142803e+01 6.937318638045923080e+01 8.193324306583735961e+01 8.427297332358722315e+01 8.415337455715672377e+01 8.265145500800952050e+01 8.960059339102160436e+01 8.396443398427838645e+01 7.557860543072955295e+01 5.470093053905966940e+01 3.718277572296367595e+01 2.239089908312269017e+01 1.131742761318360913e+01
1.431902873562441769e+01 2.346729735679002360e+01 3.710558741233958813e+01 5.531892856036142803e+01 6.960897703308057771e+01 8.193324306583735961e+01 8.415337455715672377e+01 8.478952679584949692e+01 8.669278799273799052e+01 8.890543631385462220e+01 8.427297332358722315e+01 7.487867716653516936e+01 5.237028105721692839e+01 3.702539048413556344e+01 2.239089908312269017e+01 1.131742761318360913e+01
1.431902873562441769e+01 2.405016311689978181e+01 3.166425679544171956e+01 4.991833210241719598e+01 6.960897703308057771e+01 8.171391566931379202e+01 8.415337455715672377e+01 8.563583128981684922e+01 8.890543631385462220e+01 9.076470408198038342e+01 8.136619204969802865e+01 7.022732310605005068e+01 4.836841159819910985e+01 3.246688958449384899e+01 2.239089908312269017e+01 1.131742761318360913e+01
1.131742761318360913e+01 1.900467287786091575e+01 3.166425679544171956e+01 4.466712373701466987e+01 6.184776728313178751e+01 7.641819899862272791e+01 8.354818944602928354e+01 9.121247724687289349e+01 9.167463617020281674e+01 8.935191233432462354e+01 7.697210325021572430e+01 6.114877550541033457e+01 4.420764442377149805e+01 2.988371855186814585e+01 2.061245091925496453e+01 1.131742761318360913e+01
1.131742761318360913e+01 1.900467287786091575e+01 2.508424735874757872e+01 3.885932314462701243e+01 5.740904425483253704e+01 7.025175830159983548e+01 7.913362488228739267e+01 7.913362488228739267e+01 8.521144132619598111e+01 7.932237900884217652e+01 6.686415018735819160e+01 4.946869630423054076e+01 3.693284274997096617e+01 2.448596261809960595e+01 1.786574024714679609e+01 1.131742761318360913e+01
