1.240126145362719612e+01 1.240126145362719612e+01 1.968836680358451829e+01 2.672214760614331652e+01 3.884011613256937068e+01 5.003339517447840734e+01 5.622097624617246225e+01 6.280915408616499462e+01 6.447475190557446467e+01 7.421703243256391147e+01 8.056828711594575054e+01 7.947308220165959369e+01 6.800989171950672585e+01 5.918648535261171162e+01 4.019659863314314663e+01 2.634356179176718271e+01
1.240126145362719612e+01 1.240126145362719612e+01 1.900668367688357918e+01 2.508220652197011091e+01 3.323259105298573246e+01 4.118125071076553922e+01 4.118125071076553922e+01 4.402336576286440817e+01 5.563344511153259475e+01 6.200837037614875413e+01 7.398235442954549512e+01 8.035540253491654994e+01 7.552409316198823319e+01 6.296862338180476826e+01 4.356657898909884352e+01 2.867692655914961719e+01
1.240126145362719612e+01 1.240126145362719612e+01 1.240126145362719612e+01 2.205718248473758081e+01 2.201791782224634630e+01 2.910109829511337409e+01 3.291411002738968250e+01 3.614998320996691916e+01 4.134960931786033456e+01 5.496445167320184311e+01 7.284203763726419822e+01 8.035540253491654994e+01 7.828661894609574290e+01 6.547456950981322166e+01 4.827101554555113694e+01 2.867692655914961719e+01
1.240126145362719612e+01 1.240126145362719612e+01 1.240126145362719612e+01 1.554121067355923991e+01 2.077848795059949438e+01 2.184652866484952938e+01 2.721338125049783230e+01 3.327430397176647148e+01 4.438675122505129877e+01 5.845990687253964069e+01 7.382028380787343735e+01 7.925887038597208800e+01 7.561417418008392133e+01 6.475995688895233116e+01 4.556806600352587822e+01 2.784480206693855209e+01
1.240126145362719612e+01 1.240126145362719612e+01 1.240126145362719612e+01 1.240126145362719612e+01 1.876029023377063609e+01 2.265574906915944098e+01 3.089118491476074979e+01 4.082156741458099702e+01 5.714030041221831624e+01 6.716624438192360458e+01 7.711139234144913246e+01 8.181148071520250653e+01 7.349643406979768656e+01 5.861892809472885801e+01 4.074727929851119512e+01 2.784480206693855209e+01
1.240126145362719612e+01 1.240126145362719612e+01 1.240126145362719612e+01 1.240126145362719612e+01 1.876029023377063609e+01 2.491812982698525403e+01 3.792990949327494121e+01 5.405221124920397813e+01 6.758088103401897229e+01 8.037623974439146934e+01 8.749902820080302490e+01 8.598444727686124622e+01 7.557860543072955295e+01 5.471529007881014905e+01 3.691783643158159123e+01 2.447974877772926661e+01
1.240126145362719612e+01 1.240126145362719612e+01 1.240126145362719612e+01 1.240126145362719612e+01 1.916529645999243314e+01 2.823211802530532566e+01 4.466712373701466987e+01 6.064277864988250144e+01 7.738191510480299939e+01 8.857157051649394930e+01 9.418578725477068758e+01 8.626060364901186972e+01 7.007739680217218847e+01 5.156385711329202337e+01 3.460571211762300692e+01 2.128109062835632415e+01
1.240126145362719612e+01 1.240126145362719612e+01 1.240126145362719612e+01 1.240126145362719612e+01 1.968836680358451829e+01 2.931835047538167416e+01 4.134960931786033456e+01 6.151563416551466190e+01 7.398235442954549512e+01 9.393531119541752616e+01 9.597903100260415954e+01 8.626060364901186972e+01 7.050298085409099258e+01 4.816894275067281228e+01 3.309050852807052934e+01 2.004521223866117552e+01
1.240126145362719612e+01 1.240126145362719612e+01 1.240126145362719612e+01 1.648067993864831138e+01 2.038438068207130272e+01 2.672214760614331652e+01 3.795702533492153918e+01 5.288784974934593208e+01 7.315434101131151579e+01 8.561150958761848528e+01 9.763719381890307147e+01 8.933054262387786082e+01 7.050298085409099258e+01 5.282000234207117018e+01 3.309050852807052934e+01 2.004521223866117552e+01
1.240126145362719612e+01 1.240126145362719612e+01 1.240126145362719612e+01 1.916529645999243314e+01 2.379084768037816033e+01 2.712147589757510957e+01 3.434444489167079695e+01 4.991833210241719598e+01 6.151563416551466190e+01 7.745865016879275800e+01 8.939972615873192296e+01 8.933054262387786082e+01 7.817456954459217400e+01 5.282000234207117018e+01 3.646045112751802719e+01 2.004521223866117552e+01
1.240126145362719612e+01 1.240126145362719612e+01 2.134887852884368442e+01 2.443957171532216321e+01 3.123769438168342560e+01 3.595688949551343683e+01 4.031875041940826065e+01 4.622750146674759719e+01 5.723492640265044429e+01 6.808669875355538181e+01 8.254495621590957910e+01 8.421977915490684552e+01 7.552409316198823319e+01 5.912753418509537795e+01 3.916322974870831786e+01 2.388722313519146567e+01
1.240126145362719612e+01 2.134887852884368442e+01 2.968033997951524938e+01 4.082156741458099702e+01 4.518122950157644624e+01 4.842146045077520711e+01 5.225959447292404292e+01 5.225959447292404292e+01 5.699092263761919241e+01 6.576634706792674478e+01 7.686172820678513062e+01 8.105131382437470222e+01 7.552409316198823319e+01 5.951702873142091477e+01 4.090272253052953033e+01 2.740253949565562053e+01
1.916529645999243314e+01 2.968033997951524938e+01 4.150831897898700618e+01 5.684769937770074932e+01 6.230044950506459855e+01 7.392315983043552308e+01 7.233924513597054329e+01 7.027183064411160274e+01 7.233924513597054329e+01 7.382028380787343735e+01 7.925887038597208800e+01 8.138464779795951642e+01 7.092260198686329886e+01 5.745518654504439837e+01 4.050196777686358018e+01 2.430817978568437354e+01
2.491812982698525403e+01 3.913232657323082009e+01 5.611489222101019436e+01 7.265334490700070091e+01 8.543365150913236050e+01 8.722426330995939736e+01 8.795835439079235130e+01 8.502415651630691684e+01 7.938995248440085106e+01 8.016678891133605589e+01 7.811579830170768446e+01 7.464781566574646376e+01 6.726377787057381852e+01 5.054668830582262729e+01 3.540122234784649180e+01 2.139376138143637363e+01
2.946286586408010422e+01 4.551275656485937304e+01 6.462212766539590802e+01 8.177439966418575068e+01 9.753140827031997162e+01 1.009699147788753777e+02 9.860845638623294462e+01 9.562155704412899127e+01 8.706149779331552452e+01 8.138464779795951642e+01 7.464781566574646376e+01 6.726377787057381852e+01 5.511672983615929411e+01 4.286158915103904121e+01 2.987956347373849653e+01 1.963117394123969461e+01
3.166425679544171956e+01 4.466712373701466987e+01 6.593594242301763586e+01 8.274738080798513806e+01 9.200696767979155766e+01 9.587184420260606998e+01 9.225729225982964010e+01 8.926575079481165176e+01 8.521230763551490384e+01 7.793653643996988478e+01 6.622198270698039835e+01 5.690243427649569696e+01 4.785073952751520210e+01 3.354425809837607630e+01 2.447974877772926661e+01 1.884363090396042750e+01
