1.129080288516512454e+01 1.129080288516512454e+01 1.900148538677041188e+01 2.347216435505650978e+01 3.620107984651316002e+01 4.841942721306894981e+01 6.391212355563767744e+01 7.038804940887362704e+01 7.600099241172841857e+01 7.270874284271982901e+01 6.810281663867135649e+01 7.514721685805233165e+01 8.247989935449251675e+01 9.541126538815095159e+01 1.031577979059279215e+02 9.243838237653592671e+01
1.129080288516512454e+01 1.321925932481583565e+01 1.900148538677041188e+01 2.506149323593346878e+01 3.711038315858495906e+01 5.332176293409451517e+01 6.280915408616499462e+01 6.372627608658368814e+01 6.177097305569189700e+01 6.177097305569189700e+01 5.654354298264153300e+01 6.478662602378409474e+01 8.119183708594222537e+01 8.912407975456815734e+01 9.758771755232589840e+01 8.778196673079278867e+01
1.129080288516512454e+01 1.129080288516512454e+01 1.321925932481583565e+01 2.371810545156736438e+01 3.171625398459580936e+01 4.588278330602000210e+01 5.303279176541767015e+01 5.384860872045876334e+01 4.976290032319037238e+01 4.976290032319037238e+01 5.003773941834521111e+01 6.391212355563767744e+01 8.177439966418575068e+01 9.021067945127830967e+01 9.412746113515976276e+01 8.161997241936794012e+01
1.129080288516512454e+01 1.129080288516512454e+01 1.321925932481583565e+01 1.900148538677041188e+01 2.671466263391040030e+01 3.323259105298573246e+01 4.028259510991884440e+01 4.028259510991884440e+01 4.100933687352545576e+01 4.368701651937075781e+01 5.311133994051801466e+01 6.940272252367176975e+01 8.177439966418575068e+01 8.891632129005765250e+01 8.939465175521819162e+01 7.749348845406930764e+01
1.129080288516512454e+01 1.129080288516512454e+01 1.129080288516512454e+01 1.900148538677041188e+01 2.216576983867306794e+01 2.671466263391040030e+01 3.382705366384763579e+01 3.631773714987733825e+01 4.267818246985706310e+01 5.232191484515422530e+01 6.451926431607110146e+01 7.738964644822991090e+01 8.891632129005765250e+01 9.102934636032669857e+01 8.306203373824854452e+01 6.419553049065471839e+01
1.129080288516512454e+01 1.129080288516512454e+01 1.928249292757433508e+01 2.013399627165083672e+01 2.658703569353637519e+01 2.577316125404436775e+01 3.017591088197708871e+01 3.904067844304402257e+01 5.232191484515422530e+01 6.366448746227678868e+01 7.654832224555443076e+01 8.750596641547488730e+01 9.076470408198038342e+01 8.306203373824854452e+01 7.093724615593345106e+01 5.526528261217743676e+01
1.928249292757433508e+01 2.250833959641381909e+01 2.754355161970140387e+01 3.121580730752296873e+01 3.499031030344925597e+01 3.499031030344925597e+01 4.310373690511605105e+01 5.605964008757155170e+01 6.366448746227678868e+01 8.070919396789952316e+01 8.750596641547488730e+01 9.076470408198038342e+01 8.741842784313377024e+01 7.830355309591081436e+01 5.526528261217743676e+01 4.182865475898466201e+01
2.663995030969338274e+01 3.312344800532704880e+01 4.214589204280371604e+01 4.685409477342067674e+01 5.449179102600994895e+01 5.449179102600994895e+01 6.074621983801635849e+01 7.232145449150411309e+01 8.542534919157293416e+01 9.221188102941945886e+01 9.600720101271976148e+01 9.493874541239370046e+01 8.161997241936794012e+01 6.419553049065471839e+01 4.504612485267759325e+01 2.919871648397590391e+01
4.082156741458099702e+01 5.261124189506959681e+01 6.074621983801635849e+01 7.232145449150411309e+01 7.232145449150411309e+01 8.722589585550102242e+01 8.722589585550102242e+01 9.221188102941945886e+01 9.941958169018477065e+01 1.035266411904224668e+02 1.044111096534312395e+02 9.561191459494368416e+01 7.817456954459217400e+01 5.871657715433093472e+01 4.049962657301441027e+01 2.448596261809960595e+01
5.714030041221831624e+01 7.265334490700070091e+01 8.722589585550102242e+01 8.722589585550102242e+01 1.035266411904224668e+02 1.038789211822895737e+02 1.035266411904224668e+02 1.088878431910585363e+02 1.088878431910585363e+02 1.125931726034283997e+02 1.088878431910585363e+02 9.561191459494368416e+01 7.817456954459217400e+01 5.469404108684675947e+01 3.718277572296367595e+01 2.239089908312269017e+01
7.265334490700070091e+01 8.722589585550102242e+01 9.231610744012874648e+01 8.306203373824854452e+01 8.633746521462508383e+01 1.073459074714740069e+02 1.153158245671768611e+02 1.153158245671768611e+02 1.153158245671768611e+02 1.153158245671768611e+02 1.125931726034283997e+02 1.036115003451264727e+02 8.529044888372025923e+01 5.918648535261171162e+01 3.718277572296367595e+01 2.239089908312269017e+01
9.473519511329129728e+01 9.653703986068097720e+01 7.859748398509276512e+01 7.093724615593345106e+01 8.119183708594222537e+01 1.100913383922702309e+02 1.153158245671768611e+02 1.153158245671768611e+02 1.108291441830825619e+02 1.108291441830825619e+02 1.108291441830825619e+02 1.050563061316974114e+02 8.529044888372025923e+01 6.481409894843383768e+01 4.110606386449958194e+01 2.615584270645266329e+01
9.653703986068097720e+01 7.996361312056907877e+01 4.910701475352371403e+01 5.405221124920397813e+01 7.455412916805904899e+01 9.717391710321143705e+01 1.002204825941503685e+02 9.225002602728844181e+01 9.347474057438245154e+01 9.347474057438245154e+01 1.003958189852843219e+02 1.002204825941503685e+02 8.529044888372025923e+01 6.880027883647863973e+01 5.282000234207117018e+01 3.645589184043345909e+01
1.061971289760280115e+02 8.020874936518812603e+01 6.366448746227678868e+01 7.265334490700070091e+01 9.158262752446150046e+01 9.046465395952149890e+01 7.913341340603338381e+01 7.680967150154476997e+01 7.070913606626830017e+01 7.743578373271708415e+01 7.913341340603338381e+01 8.912407975456815734e+01 8.950001426183381170e+01 7.817456954459217400e+01 5.918648535261171162e+01 4.019659863314314663e+01
1.016355061717003991e+02 8.020874936518812603e+01 8.500805693559770759e+01 8.424586371500573989e+01 8.473305956977100095e+01 7.093724615593345106e+01 6.177097305569189700e+01 5.175558132852962245e+01 5.039388166334390462e+01 5.342828033885272276e+01 7.083210424379701919e+01 7.514721685805233165e+01 8.058135902217482283e+01 7.817456954459217400e+01 5.912753418509537795e+01 4.802721591534514545e+01
9.347474057438245154e+01 9.225002602728844181e+01 9.046465395952149890e+01 7.913341340603338381e+01 6.324839297575545061e+01 5.241538549107528411e+01 3.921325040625543323e+01 3.508887196895419436e+01 3.293509973817581482e+01 3.893760198929871308e+01 4.939757920521041257e+01 6.280915408616499462e+01 7.680967150154476997e+01 7.070913606626830017e+01 5.374912771504440201e+01 4.054113073728782979e+01
