1.216512886113930492e+01 1.847219990565186265e+01 2.317508351857592785e+01 2.770098995973310352e+01 3.368726391460675273e+01 3.863651584168134434e+01 4.131807145929622038e+01 4.522485136042413245e+01 4.499493264192604158e+01 4.499493264192604158e+01 4.522485136042413245e+01 4.522485136042413245e+01 4.522485136042413245e+01 3.953425550044163828e+01
1.847219990565186265e+01 2.172688955940435562e+01 2.770098995973310352e+01 3.368726391460675273e+01 4.120355590408082946e+01 4.654855386759698632e+01 4.499493264192604158e+01 4.499493264192604158e+01 4.366752728167081443e+01 4.499493264192604158e+01 4.298326179900426780e+01 4.499493264192604158e+01 4.522485136042413245e+01 4.490074115822233836e+01
1.971379928817915328e+01 2.588714239006633377e+01 3.414583649563797252e+01 4.399893291783650540e+01 4.654855386759698632e+01 4.654855386759698632e+01 4.522485136042413245e+01 4.366752728167081443e+01 4.366752728167081443e+01 4.499493264192604158e+01 4.298326179900426780e+01 5.182946506348832827e+01 5.182946506348832827e+01 4.179322532438445137e+01
2.172688955940435562e+01 2.770098995973310352e+01 3.991079626439054095e+01 4.854916593671967462e+01 5.229649255530086549e+01 5.182946506348832827e+01 4.499493264192604158e+01 4.179322532438445137e+01 4.131807145929622038e+01 4.298326179900426780e+01 4.499493264192604158e+01 5.182946506348832827e+01 4.490074115822233836e+01 4.075457719974198767e+01
2.134324204257557867e+01 3.338254058801700808e+01 4.317911192173303192e+01 5.389212776719878661e+01 5.654030942530055626e+01 5.182946506348832827e+01 4.522485136042413245e+01 4.522485136042413245e+01 4.466335179434552316e+01 4.788567283298733912e+01 5.229649255530086549e+01 5.182946506348832827e+01 4.179322532438445137e+01 3.540259428764992577e+01
2.286543029845867636e+01 3.338254058801700808e+01 4.317911192173303192e+01 5.121277752874803468e+01 5.654030942530055626e+01 5.654030942530055626e+01 5.090159785198612497e+01 4.788567283298733912e+01 5.338916276078680312e+01 5.338916276078680312e+01 5.654030942530055626e+01 4.876491478729406737e+01 4.179322532438445137e+01 3.201807958272513588e+01
2.286543029845867636e+01 3.338254058801700808e+01 4.317911192173303192e+01 5.121277752874803468e+01 5.389212776719878661e+01 5.654030942530055626e+01 5.882810194275503335e+01 5.882810194275503335e+01 6.056931362350177039e+01 6.094788724662303991e+01 5.654030942530055626e+01 5.064847929999460519e+01 3.793028938901370140e+01 2.708810561061359579e+01
2.134324204257557867e+01 2.921056146491206817e+01 3.783919616154197030e+01 4.820369319153883936e+01 5.121277752874803468e+01 6.348165195593077925e+01 6.348165195593077925e+01 6.291720153154941642e+01 6.499476420620240447e+01 6.094788724662303991e+01 5.358112506869689895e+01 4.202732061536232777e+01 3.201807958272513588e+01 2.354561180966722844e+01
2.134324204257557867e+01 2.286543029845867636e+01 3.783919616154197030e+01 4.381596246013310036e+01 5.190753721071507698e+01 6.192777439435968034e+01 6.323195447355874421e+01 6.432942849771441729e+01 6.538560250777837268e+01 6.126924811558220085e+01 5.064847929999460519e+01 3.697252298156498540e+01 2.727104660687365723e+01 2.257985658928300055e+01
1.357406805114503889e+01 2.134324204257557867e+01 2.325476052806439142e+01 3.783919616154197030e+01 4.253260336922389229e+01 5.121277752874803468e+01 6.323195447355874421e+01 6.589813906204807381e+01 6.202273888433143867e+01 5.358112506869689895e+01 4.202732061536232777e+01 3.096658276015367406e+01 2.354561180966722844e+01 1.610410037831992724e+01
1.357406805114503889e+01 2.038955149480424822e+01 2.325476052806439142e+01 2.921056146491206817e+01 4.059488843254168700e+01 5.121277752874803468e+01 6.113517771429602021e+01 5.934616967157018763e+01 5.358112506869689895e+01 4.722497876847191378e+01 3.899165365414597773e+01 2.708810561061359579e+01 2.257985658928300055e+01 1.216512886113930492e+01
1.216512886113930492e+01 1.889404785573351475e+01 2.172688955940435562e+01 2.879909679611188267e+01 3.863651584168134434e+01 4.820369319153883936e+01 5.934616967157018763e+01 5.200691920118921985e+01 4.722497876847191378e+01 4.044939896139997870e+01 2.847329172505004635e+01 2.372833240030174906e+01 1.610410037831992724e+01 1.216512886113930492e+01
1.216512886113930492e+01 1.971379928817915328e+01 2.494747500542675667e+01 3.414583649563797252e+01 4.298326179900426780e+01 4.820369319153883936e+01 5.182946506348832827e+01 4.756723695525482754e+01 4.202732061536232777e+01 3.096658276015367406e+01 2.354561180966722844e+01 1.610410037831992724e+01 1.610410037831992724e+01 1.413688399082093916e+01
1.413688399082093916e+01 2.172688955940435562e+01 2.770098995973310352e+01 3.626198403363029144e+01 4.298326179900426780e+01 5.182946506348832827e+01 4.366752728167081443e+01 4.202732061536232777e+01 3.201807958272513588e+01 2.708810561061359579e+01 2.107201756854596653e+01 1.889404785573351475e+01 1.847219990565186265e+01 1.803035029528814448e+01
