1.288691113841897895e+01 1.288691113841897895e+01 1.288691113841897895e+01 1.288691113841897895e+01 1.288691113841897895e+01 1.965377095167831811e+01 2.588714239006633377e+01 3.534320857442686759e+01 4.999473949873976864e+01 6.113167520072192929e+01 6.402011782996342504e+01 5.720099184569695439e+01 4.237412406411156240e+01 3.356771642742052819e+01
1.288691113841897895e+01 1.288691113841897895e+01 1.288691113841897895e+01 1.288691113841897895e+01 1.693456681318058088e+01 2.344978832937255220e+01 3.004091692468419694e+01 4.279275205564257334e+01 5.541726868293150687e+01 6.601506423843994753e+01 6.542631781139616010e+01 5.667177514220234258e+01 4.407393883281142166e+01 3.075123017263690883e+01
1.288691113841897895e+01 1.288691113841897895e+01 1.288691113841897895e+01 1.288691113841897895e+01 1.965377095167831811e+01 2.705073666992511505e+01 3.838562086683602104e+01 5.341037864816203751e+01 6.360893901464558553e+01 7.077096342340379920e+01 6.542631781139616010e+01 5.595496173010894125e+01 4.057581591414307809e+01 2.847329172505004635e+01
1.288691113841897895e+01 1.288691113841897895e+01 1.288691113841897895e+01 1.877071989078400804e+01 2.344978832937255220e+01 3.293090881389959179e+01 4.748570622206666059e+01 6.113167520072192929e+01 7.019458788776256597e+01 6.974619596140118460e+01 6.128130319897565670e+01 5.224363479186511938e+01 3.697252298156498540e+01 2.283519796155548676e+01
1.288691113841897895e+01 1.288691113841897895e+01 1.288691113841897895e+01 1.965377095167831811e+01 2.705073666992511505e+01 4.135957485107039133e+01 5.341037864816203751e+01 6.694835956243080943e+01 7.077096342340379920e+01 6.974619596140118460e+01 5.959605911430536196e+01 4.407393883281142166e+01 3.075123017263690883e+01 2.199632356407661504e+01
1.288691113841897895e+01 1.288691113841897895e+01 1.877071989078400804e+01 2.344978832937255220e+01 3.160544981020042599e+01 4.748570622206666059e+01 6.113167520072192929e+01 7.019458788776256597e+01 7.137050713626521770e+01 6.520120250479057233e+01 5.317476285195879626e+01 3.697252298156498540e+01 2.847329172505004635e+01 1.606039593541756361e+01
1.288691113841897895e+01 1.288691113841897895e+01 1.965377095167831811e+01 2.705073666992511505e+01 4.135957485107039133e+01 5.341037864816203751e+01 6.694835956243080943e+01 7.077096342340379920e+01 6.974619596140118460e+01 5.937398582160611937e+01 4.407393883281142166e+01 3.323260162523924066e+01 2.296010597315549617e+01 1.606039593541756361e+01
1.288691113841897895e+01 1.877071989078400804e+01 2.344978832937255220e+01 3.160544981020042599e+01 4.748570622206666059e+01 6.113167520072192929e+01 7.019458788776256597e+01 7.214448051721105060e+01 6.562838316049106879e+01 5.063998052439234954e+01 3.697252298156498540e+01 2.847329172505004635e+01 1.606039593541756361e+01 1.288691113841897895e+01
1.288691113841897895e+01 1.965377095167831811e+01 2.705073666992511505e+01 3.679494076349064358e+01 5.341037864816203751e+01 6.694835956243080943e+01 7.077096342340379920e+01 6.844997988842420966e+01 5.937398582160611937e+01 4.125842567781239723e+01 3.323260162523924066e+01 2.258121670654506019e+01 1.606039593541756361e+01 1.288691113841897895e+01
1.877071989078400804e+01 2.344978832937255220e+01 3.293090881389959179e+01 4.748570622206666059e+01 6.113167520072192929e+01 7.019458788776256597e+01 7.090748707535900053e+01 6.562838316049106879e+01 5.063998052439234954e+01 3.697252298156498540e+01 2.258121670654506019e+01 1.606039593541756361e+01 1.288691113841897895e+01 1.288691113841897895e+01
1.965377095167831811e+01 2.851502433730589203e+01 3.838562086683602104e+01 5.341037864816203751e+01 6.694835956243080943e+01 7.077096342340379920e+01 6.755710491278811958e+01 5.959605911430536196e+01 4.125842567781239723e+01 3.075123017263690883e+01 2.199632356407661504e+01 1.606039593541756361e+01 1.288691113841897895e+01 1.288691113841897895e+01
2.367502319400761124e+01 3.534320857442686759e+01 4.748570622206666059e+01 6.113167520072192929e+01 7.019458788776256597e+01 7.090748707535900053e+01 6.411949655210739252e+01 5.063998052439234954e+01 3.697252298156498540e+01 2.723034857588123359e+01 1.606039593541756361e+01 1.288691113841897895e+01 1.288691113841897895e+01 1.288691113841897895e+01
2.851502433730589203e+01 4.135957485107039133e+01 5.341037864816203751e+01 6.694835956243080943e+01 7.077096342340379920e+01 6.562838316049106879e+01 5.937398582160611937e+01 4.125842567781239723e+01 3.075123017263690883e+01 2.258121670654506019e+01 1.606039593541756361e+01 1.288691113841897895e+01 1.288691113841897895e+01 1.288691113841897895e+01
3.293090881389959179e+01 4.695391816317268763e+01 5.970264961191548991e+01 6.948710265025903254e+01 6.974619596140118460e+01 6.078678226631504344e+01 4.663979467451617467e+01 3.651137489839996420e+01 2.258121670654506019e+01 1.606039593541756361e+01 1.288691113841897895e+01 1.288691113841897895e+01 1.288691113841897895e+01 1.288691113841897895e+01
