1.297401984949377507e+01 2.013970264920080666e+01 2.307989546242196965e+01 3.322093473646240369e+01 3.591680854473347750e+01 4.159364994952940009e+01 5.139663274229836532e+01 5.473214524085270227e+01 6.370239743185522485e+01 7.099662277539917454e+01 7.494788680141914483e+01 7.180880530477017487e+01 6.017510114187754766e+01 4.173636324376357720e+01
1.297401984949377507e+01 1.297401984949377507e+01 2.013970264920080666e+01 2.732372316936616485e+01 2.732372316936616485e+01 3.481841773990936417e+01 4.035190108882670046e+01 4.583503502392150608e+01 5.805194589977777042e+01 7.084690540035177264e+01 7.826706719046423189e+01 7.395325540277843857e+01 6.320200336751075554e+01 4.555051365031827260e+01
1.297401984949377507e+01 1.297401984949377507e+01 1.694656262187221074e+01 2.123684915149359043e+01 2.550435665833341758e+01 2.954482426556817032e+01 3.764282049129840857e+01 4.695391816317268763e+01 6.082026814084377264e+01 6.994855636048642111e+01 7.750500700169919810e+01 7.177138995348973083e+01 6.269285376916939612e+01 4.555051365031827260e+01
1.297401984949377507e+01 1.297401984949377507e+01 1.694656262187221074e+01 1.965377095167831811e+01 2.441673403844344037e+01 3.228701332227191756e+01 4.279275205564257334e+01 5.712613443846347394e+01 6.694407189463183272e+01 7.566838003536948065e+01 7.694467075144277146e+01 7.043883464829163188e+01 5.595496173010894125e+01 4.341271648791434501e+01
1.297401984949377507e+01 1.297401984949377507e+01 1.297401984949377507e+01 1.965377095167831811e+01 2.705073666992511505e+01 3.922374140365298700e+01 5.068274574149518230e+01 6.636271732378294530e+01 7.590040724829508179e+01 8.152519274775383451e+01 8.257432953485235316e+01 7.241701838272399527e+01 5.595496173010894125e+01 3.878256731385647527e+01
1.297401984949377507e+01 1.297401984949377507e+01 1.297401984949377507e+01 1.965377095167831811e+01 2.887266786129556095e+01 4.308074772852540946e+01 5.621474520362075111e+01 7.084690540035177264e+01 8.433389337548868525e+01 8.771232387053439084e+01 8.296612616849564859e+01 6.733604952197714510e+01 5.238436959987667052e+01 3.697252298156498540e+01
1.297401984949377507e+01 1.297401984949377507e+01 1.694656262187221074e+01 1.965377095167831811e+01 2.809722644479312237e+01 4.417962887592690890e+01 5.791921736329207704e+01 7.221941873945166890e+01 8.518132350843316658e+01 9.214916025328703597e+01 8.229851498752651651e+01 7.241701838272399527e+01 5.238436959987667052e+01 3.356771642742052819e+01
1.297401984949377507e+01 1.297401984949377507e+01 1.824179470547010595e+01 2.176941779221708373e+01 2.809722644479312237e+01 4.119209542015845216e+01 5.510641182832056728e+01 6.746358200954406925e+01 8.493168592541853457e+01 8.972896733746307518e+01 8.248006162210936054e+01 7.241701838272399527e+01 5.238436959987667052e+01 3.450604456424660071e+01
1.297401984949377507e+01 1.411507868600499549e+01 2.176941779221708373e+01 2.622708630572149602e+01 3.251399029034904231e+01 3.784383583082038882e+01 5.019303853828463247e+01 6.370239743185522485e+01 7.325124619221247713e+01 8.540478826464558892e+01 8.360848019624849314e+01 7.241701838272399527e+01 5.788840653957058180e+01 3.905621322172046916e+01
1.411507868600499549e+01 2.317508351857592785e+01 2.622708630572149602e+01 3.354750743654665257e+01 3.561683461155583075e+01 4.219147470147335355e+01 4.846315794421656875e+01 5.659898483235392064e+01 7.099662277539917454e+01 7.791590966418458208e+01 8.360848019624849314e+01 7.241701838272399527e+01 5.788840653957058180e+01 3.905621322172046916e+01
2.317508351857592785e+01 3.228701332227191756e+01 4.010798884874222381e+01 4.322302244216924549e+01 4.916501334428203052e+01 5.528484647196297175e+01 5.772740915022864527e+01 6.360893901464558553e+01 7.019359519888115528e+01 7.700901265472475643e+01 7.884457204347262405e+01 7.241701838272399527e+01 5.788840653957058180e+01 4.173636324376357720e+01
3.004091692468419694e+01 4.279275205564257334e+01 5.257745640686931665e+01 6.536263922824504391e+01 6.978252384189772783e+01 6.876074191696049809e+01 6.876074191696049809e+01 7.162554383954066850e+01 7.118411691010123832e+01 7.756407290461254433e+01 7.884457204347262405e+01 6.757944943562254991e+01 5.595496173010894125e+01 3.878256731385647527e+01
3.922374140365298700e+01 5.454965704449006836e+01 6.616785135373397964e+01 7.706721521355026994e+01 8.087545542389271702e+01 9.038093819252975436e+01 8.051597091188743605e+01 8.051597091188743605e+01 7.694467075144277146e+01 7.750500700169919810e+01 7.005089156141583828e+01 6.301525045069187314e+01 5.063998052439234954e+01 3.697252298156498540e+01
4.633048950072192440e+01 6.113369623313214163e+01 7.590040724829508179e+01 8.871648113383713508e+01 9.314443674872455858e+01 9.314443674872455858e+01 8.811883437891002302e+01 8.328003625069062821e+01 7.734009445608572264e+01 7.167947384585411896e+01 6.470643755806865727e+01 5.351497662401389732e+01 4.125842567781239723e+01 3.075103572145540554e+01
