1.111111111111111049e-01 1.111111111111111049e-01 1.111111111111111049e-01 1.111111111111111049e-01 1.111111111111111049e-01 1.111111111111111049e-01 1.111111111111111049e-01 1.266666666666666607e+00 1.800000000000000044e+00 1.500000000000000000e+00 3.333333333333333148e-01 3.333333333333333148e-01 1.533333333333333215e+00 2.399999999999999911e+00 4.444444444444444198e-01 1.199999999999999734e+00 1.866666666666666474e+00 1.688888888888888884e+00 3.333333333333333148e-01 1.866666666666666474e+00 2.666666666666666519e+00 1.722222222222221877e+00 1.958333333333333037e+00 8.888888888888888395e-01 1.111111111111111049e-01 1.111111111111111049e-01
1.111111111111111049e-01 1.111111111111111049e-01 1.111111111111111049e-01 1.111111111111111049e-01 1.111111111111111049e-01 1.111111111111111049e-01 1.111111111111111049e-01 2.222222222222221877e+00 3.333333333333333148e-01 1.799999999999999600e+00 8.000000000000000444e-01 1.111111111111111049e-01 1.266666666666666607e+00 8.888888888888888395e-01 3.333333333333333148e-01 8.000000000000000444e-01 3.333333333333333148e-01 2.399999999999999911e+00 4.444444444444444198e-01 1.777777777777777679e+00 3.333333333333333148e-01 3.333333333333333148e-01 1.866666666666666474e+00 8.888888888888888395e-01 1.111111111111111049e-01 1.111111111111111049e-01
1.111111111111111049e-01 1.111111111111111049e-01 1.111111111111111049e-01 1.111111111111111049e-01 1.111111111111111049e-01 1.111111111111111049e-01 3.333333333333333148e-01 3.333333333333333148e-01 1.722222222222222099e+00 2.375000000000000000e+00 1.866666666666666474e+00 2.375000000000000000e+00 3.555555555555555802e+00 1.000000000000000000e+00 4.166666666666666297e-01 4.166666666666666297e-01 4.166666666666666297e-01 1.866666666666666474e+00 3.333333333333333148e-01 7.333333333333331705e-01 1.444444444444444198e+00 1.800000000000000044e+00 1.500000000000000000e+00 4.444444444444444198e-01 1.111111111111111049e-01 1.111111111111111049e-01
1.111111111111111049e-01 1.111111111111111049e-01 1.111111111111111049e-01 1.111111111111111049e-01 1.111111111111111049e-01 1.111111111111111049e-01 1.111111111111111049e-01 3.333333333333333148e-01 2.466666666666666341e+00 1.533333333333333215e+00 2.977777777777777413e+00 1.533333333333333215e+00 2.938888888888888573e+01 6.786666666666666003e+01 6.786666666666666003e+01 6.786666666666666003e+01 8.608333333333332860e+01 1.137777777777777857e+02 3.600000000000000000e+01 5.333333333333333259e-01 1.722222222222221877e+00 8.000000000000000444e-01 1.466666666666666341e+00 6.666666666666666297e-01 1.111111111111111049e-01 1.111111111111111049e-01
1.111111111111111049e-01 1.111111111111111049e-01 1.111111111111111049e-01 1.111111111111111049e-01 1.111111111111111049e-01 1.111111111111111049e-01 9.444444444444443088e-01 1.000000000000000000e+00 4.426666666666665861e+00 4.588888888888888573e+01 2.408333333333333215e+01 9.352380952380951840e+01 1.137777777777777857e+02 1.680888888888888744e+02 1.680888888888888744e+02 1.664000000000000057e+02 1.665999999999999943e+02 1.662500000000000000e+02 1.428666666666666458e+02 6.833333333333334281e+01 4.444444444444444198e-01 1.000000000000000000e+00 1.333333333333333259e+00 6.666666666666666297e-01 1.111111111111111049e-01 1.111111111111111049e-01
1.111111111111111049e-01 1.111111111111111049e-01 1.111111111111111049e-01 1.111111111111111049e-01 1.111111111111111049e-01 1.111111111111111049e-01 3.333333333333333148e-01 1.533333333333333215e+00 2.311111111111110894e+00 4.416666666666666430e+01 1.683333333333333144e+02 1.650833333333333144e+02 1.674666666666666401e+02 1.675999999999999659e+02 1.663333333333333144e+02 1.661666666666666572e+02 1.667500000000000000e+02 1.604722222222222001e+02 1.668000000000000114e+02 4.250000000000000000e+01 2.233333333333333393e+00 1.800000000000000044e+00 1.055555555555555580e+00 9.444444444444443088e-01 1.111111111111111049e-01 1.111111111111111049e-01
1.111111111111111049e-01 1.111111111111111049e-01 1.111111111111111049e-01 1.111111111111111049e-01 1.111111111111111049e-01 1.111111111111111049e-01 1.111111111111111049e-01 1.500000000000000000e+00 3.333333333333333148e-01 6.693333333333332291e+01 1.664444444444444287e+02 1.611066666666666549e+02 1.667500000000000000e+02 1.668444444444444343e+02 8.983333333333332860e+01 8.488888888888888573e+01 1.339999999999999716e+02 1.668000000000000114e+02 1.668000000000000114e+02 4.250000000000000000e+01 4.444444444444444198e-01 1.266666666666666385e+00 2.222222222222221877e+00 6.666666666666666297e-01 1.111111111111111049e-01 1.111111111111111049e-01
1.111111111111111049e-01 1.111111111111111049e-01 1.111111111111111049e-01 1.111111111111111049e-01 1.111111111111111049e-01 1.111111111111111049e-01 3.333333333333333148e-01 7.222222222222222099e-01 8.000000000000000444e-01 8.291666666666665719e+01 4.591666666666667140e+01 1.023999999999999915e+02 6.853333333333333144e+01 3.975000000000000000e+01 4.327777777777777146e+01 2.208333333333333481e+00 1.083333333333333259e+00 1.132000000000000028e+02 1.657916666666666572e+02 9.966666666666665719e+01 2.399999999999999911e+00 2.666666666666666519e+00 8.666666666666665853e-01 3.333333333333333148e-01 1.111111111111111049e-01 1.111111111111111049e-01
1.111111111111111049e-01 1.111111111111111049e-01 1.111111111111111049e-01 1.111111111111111049e-01 1.111111111111111049e-01 1.111111111111111049e-01 1.111111111111111049e-01 7.222222222222222099e-01 2.600000000000000089e+00 3.733333333333332948e+00 3.899999999999999467e+00 2.925925925925926041e+00 8.500000000000000000e+00 2.399999999999999911e+00 1.083333333333333259e+00 1.888888888888888618e+00 9.750000000000000000e+00 1.393333333333333144e+02 1.640000000000000000e+02 6.766666666666665719e+01 3.133333333333332860e+00 3.333333333333333148e-01 1.000000000000000000e+00 4.444444444444444198e-01 1.111111111111111049e-01 1.111111111111111049e-01
1.111111111111111049e-01 1.111111111111111049e-01 1.111111111111111049e-01 1.111111111111111049e-01 1.111111111111111049e-01 1.111111111111111049e-01 1.111111111111111049e-01 2.599999999999999645e+00 3.629629629629629761e+00 2.133333333333333304e+00 1.055555555555555580e+00 4.444444444444444198e-01 2.466666666666666341e+00 5.333333333333333259e-01 3.222222222222221877e+00 4.026666666666666572e+01 1.393333333333333144e+02 1.632999999999999545e+02 1.002666666666666657e+02 1.722222222222221877e+00 2.000000000000000000e+00 1.777777777777777679e+00 8.888888888888888395e-01 1.111111111111111049e-01 1.111111111111111049e-01 1.111111111111111049e-01
1.111111111111111049e-01 1.111111111111111049e-01 1.111111111111111049e-01 1.111111111111111049e-01 1.111111111111111049e-01 1.111111111111111049e-01 3.333333333333333148e-01 3.333333333333333148e-01 2.266666666666666607e+00 1.055555555555555580e+00 2.222222222222221877e+00 4.166666666666666297e-01 4.166666666666666297e-01 3.600000000000000089e+00 3.753333333333333144e+01 1.137777777777777857e+02 1.358666666666666742e+02 1.694166666666666572e+02 4.250000000000000000e+01 1.199999999999999734e+00 2.088888888888888573e+00 6.666666666666667407e-01 4.444444444444444198e-01 1.111111111111111049e-01 1.111111111111111049e-01 1.111111111111111049e-01
1.111111111111111049e-01 1.111111111111111049e-01 1.111111111111111049e-01 1.111111111111111049e-01 1.111111111111111049e-01 1.111111111111111049e-01 1.111111111111111049e-01 4.166666666666666297e-01 1.599999999999999867e+00 1.000000000000000000e+00 1.533333333333333215e+00 9.083333333333332149e+00 6.155555555555554292e+01 1.272666666666666515e+02 1.137777777777777857e+02 1.668444444444444343e+02 1.595999999999999659e+02 1.008444444444444343e+02 4.327777777777777146e+01 1.266666666666666385e+00 2.199999999999999734e+00 1.000000000000000000e+00 2.399999999999999911e+00 1.111111111111111049e-01 1.111111111111111049e-01 1.111111111111111049e-01
1.111111111111111049e-01 1.111111111111111049e-01 1.111111111111111049e-01 1.111111111111111049e-01 1.111111111111111049e-01 1.111111111111111049e-01 1.111111111111111049e-01 1.688888888888888884e+00 5.333333333333333259e-01 4.166666666666666297e-01 6.220000000000000284e+01 1.340666666666666629e+02 1.670222222222222399e+02 1.686666666666666572e+02 1.694166666666666572e+02 1.348666666666666458e+02 7.320000000000000284e+01 3.911111111111110006e+01 4.444444444444444198e-01 1.000000000000000000e+00 1.866666666666666474e+00 1.500000000000000000e+00 2.933333333333332682e+00 3.333333333333333148e-01 1.111111111111111049e-01 1.111111111111111049e-01
1.111111111111111049e-01 1.111111111111111049e-01 1.111111111111111049e-01 1.111111111111111049e-01 1.111111111111111049e-01 1.111111111111111049e-01 3.333333333333333148e-01 7.222222222222222099e-01 3.305555555555555003e+01 1.272666666666666515e+02 1.137777777777777857e+02 1.652500000000000000e+02 1.668444444444444343e+02 1.665999999999999943e+02 1.679166666666666572e+02 8.633333333333332860e+01 4.444444444444444198e-01 1.813333333333333242e+00 6.666666666666666297e-01 4.166666666666666297e-01 8.888888888888888395e-01 2.055555555555555358e+00 4.444444444444444198e-01 4.444444444444444198e-01 1.111111111111111049e-01 1.111111111111111049e-01
3.333333333333333148e-01 1.111111111111111049e-01 3.333333333333333148e-01 3.333333333333333148e-01 3.333333333333333148e-01 1.111111111111111049e-01 3.333333333333333148e-01 4.766666666666666430e+01 1.272666666666666515e+02 1.615999999999999943e+02 1.600555555555555713e+02 1.655333333333333030e+02 1.661666666666666572e+02 8.983333333333332860e+01 7.320000000000000284e+01 3.653333333333333144e+01 2.000000000000000000e+00 1.466666666666666341e+00 1.444444444444444198e+00 3.333333333333333148e-01 3.333333333333333148e-01 1.866666666666666474e+00 3.333333333333333148e-01 1.111111111111111049e-01 1.111111111111111049e-01 1.111111111111111049e-01
1.000000000000000000e+00 5.333333333333333259e-01 3.333333333333333148e-01 1.111111111111111049e-01 1.958333333333333037e+00 5.333333333333333259e-01 7.777777777777776791e-01 7.261111111111110006e+01 1.674166666666666572e+02 1.694166666666666572e+02 1.664444444444444571e+02 1.107777777777777715e+02 3.975000000000000000e+01 3.733333333333332948e+00 2.222222222222221877e+00 4.444444444444444198e-01 2.933333333333333126e+00 3.333333333333333148e-01 7.333333333333331705e-01 6.666666666666667407e-01 3.333333333333333148e-01 1.777777777777777679e+00 1.533333333333333215e+00 1.111111111111111049e-01 1.111111111111111049e-01 1.111111111111111049e-01
1.000000000000000000e+00 1.533333333333333215e+00 1.866666666666666474e+00 1.533333333333333215e+00 1.500000000000000000e+00 1.533333333333333215e+00 8.266666666666667718e-01 1.003333333333333286e+02 1.600555555555555713e+02 1.665000000000000000e+02 1.000666666666666629e+02 1.055555555555555580e+00 1.083333333333333259e+00 2.666666666666666519e+00 2.733333333333333393e+00 2.222222222222222321e+00 1.466666666666666341e+00 8.888888888888888395e-01 3.333333333333333148e-01 1.466666666666666341e+00 8.000000000000000444e-01 1.944444444444444420e+00 1.000000000000000000e+00 3.333333333333333148e-01 1.111111111111111049e-01 1.111111111111111049e-01
1.083333333333333259e+00 1.266666666666666607e+00 2.977777777777777413e+00 1.466666666666666563e+00 1.500000000000000000e+00 1.533333333333333215e+00 6.693333333333332291e+01 1.674166666666666572e+02 1.665777777777777544e+02 1.018666666666666600e+02 5.238888888888887863e+01 3.066666666666666430e+00 4.166666666666666297e-01 2.977777777777777413e+00 2.592592592592592560e+00 4.166666666666666297e-01 4.166666666666666297e-01 5.839999999999998970e+00 1.800000000000000044e+00 1.199999999999999734e+00 1.500000000000000000e+00 1.833333333333333037e+00 3.333333333333333148e-01 4.444444444444444198e-01 1.111111111111111049e-01 1.111111111111111049e-01
2.666666666666666519e+00 1.500000000000000000e+00 8.666666666666665853e-01 4.444444444444444198e-01 1.722222222222221877e+00 1.500000000000000000e+00 6.826666666666666572e+01 1.650222222222221831e+02 1.655555555555555429e+02 9.966666666666665719e+01 4.475000000000000000e+01 6.579999999999999716e+01 8.608333333333332860e+01 8.316666666666667140e+01 6.786666666666666003e+01 8.588888888888887152e+01 1.137777777777777857e+02 3.600000000000000000e+01 2.977777777777777413e+00 1.533333333333333215e+00 1.599999999999999867e+00 1.333333333333333259e+00 4.166666666666666297e-01 1.111111111111111049e-01 1.111111111111111049e-01 1.111111111111111049e-01
2.000000000000000000e+00 1.599999999999999867e+00 1.000000000000000000e+00 3.333333333333333148e-01 1.466666666666666563e+00 1.500000000000000000e+00 4.416666666666666430e+01 1.674166666666666572e+02 1.663611111111111143e+02 1.263888888888888857e+02 1.024666666666666544e+02 1.137777777777777857e+02 1.329333333333333371e+02 1.679583333333333144e+02 1.652500000000000000e+02 1.663611111111111143e+02 1.680000000000000000e+02 6.833333333333334281e+01 2.977777777777777857e+00 1.800000000000000044e+00 4.444444444444444198e-01 4.166666666666666297e-01 1.777777777777777679e+00 3.333333333333333148e-01 1.111111111111111049e-01 1.111111111111111049e-01
1.944444444444444420e+00 1.800000000000000044e+00 4.166666666666666297e-01 1.000000000000000000e+00 1.466666666666666563e+00 1.500000000000000000e+00 6.693333333333332291e+01 1.662500000000000000e+02 1.686666666666666572e+02 1.679583333333333144e+02 1.672888888888888914e+02 1.694166666666666572e+02 1.658666666666666458e+02 1.650833333333333144e+02 1.662500000000000000e+02 1.665000000000000000e+02 1.674666666666666401e+02 4.250000000000000000e+01 5.257142857142856229e+00 3.200000000000000178e+00 1.111111111111111160e+00 1.533333333333333215e+00 1.599999999999999867e+00 4.444444444444444198e-01 1.111111111111111049e-01 1.111111111111111049e-01
1.000000000000000000e+00 1.611111111111110938e+00 1.904761904761904656e+00 1.055555555555555580e+00 1.083333333333333259e+00 4.444444444444444198e-01 3.446666666666666856e+01 8.433333333333332860e+01 1.679166666666666572e+02 1.688000000000000114e+02 1.675999999999999659e+02 1.668444444444444343e+02 1.661666666666666572e+02 1.667500000000000000e+02 1.679166666666666572e+02 1.438333333333333144e+02 8.277777777777777146e+01 4.327777777777777146e+01 2.933333333333332682e+00 4.444444444444444198e-01 1.199999999999999734e+00 2.599999999999999645e+00 3.333333333333333148e-01 8.888888888888888395e-01 1.111111111111111049e-01 1.111111111111111049e-01
6.666666666666667407e-01 4.444444444444444198e-01 1.777777777777777679e+00 4.444444444444444198e-01 4.166666666666666297e-01 3.333333333333333148e-01 3.975000000000000000e+01 3.433333333333332860e+01 8.433333333333332860e+01 8.433333333333332860e+01 4.175000000000000000e+01 1.261666666666666572e+02 3.975000000000000000e+01 3.975000000000000000e+01 4.175000000000000000e+01 3.975000000000000000e+01 2.866666666666666785e+01 4.444444444444444198e-01 4.444444444444444198e-01 4.444444444444444198e-01 4.444444444444444198e-01 9.444444444444443088e-01 1.000000000000000000e+00 3.333333333333333148e-01 1.111111111111111049e-01 1.111111111111111049e-01
3.333333333333333148e-01 4.166666666666666297e-01 3.333333333333333148e-01 4.444444444444444198e-01 1.111111111111111049e-01 1.111111111111111049e-01 3.333333333333333148e-01 3.333333333333333148e-01 4.444444444444444198e-01 4.444444444444444198e-01 3.433333333333332860e+01 4.444444444444444198e-01 4.444444444444444198e-01 4.444444444444444198e-01 4.444444444444444198e-01 4.444444444444444198e-01 4.444444444444444198e-01 4.444444444444444198e-01 1.111111111111111049e-01 1.111111111111111049e-01 4.166666666666666297e-01 4.166666666666666297e-01 1.466666666666666341e+00 4.444444444444444198e-01 1.111111111111111049e-01 1.111111111111111049e-01
1.111111111111111049e-01 1.111111111111111049e-01 1.111111111111111049e-01 1.111111111111111049e-01 1.111111111111111049e-01 1.111111111111111049e-01 1.111111111111111049e-01 1.111111111111111049e-01 1.111111111111111049e-01 1.111111111111111049e-01 1.111111111111111049e-01 1.111111111111111049e-01 1.111111111111111049e-01 1.111111111111111049e-01 1.111111111111111049e-01 1.111111111111111049e-01 1.111111111111111049e-01 1.111111111111111049e-01 1.111111111111111049e-01 1.111111111111111049e-01 1.111111111111111049e-01 1.111111111111111049e-01 1.111111111111111049e-01 1.111111111111111049e-01 1.111111111111111049e-01 1.111111111111111049e-01
1.111111111111111049e-01 1.111111111111111049e-01 1.111111111111111049e-01 1.111111111111111049e-01 1.111111111111111049e-01 1.111111111111111049e-01 1.111111111111111049e-01 1.111111111111111049e-01 1.111111111111111049e-01 1.111111111111111049e-01 1.111111111111111049e-01 1.111111111111111049e-01 1.111111111111111049e-01 1.111111111111111049e-01 1.111111111111111049e-01 1.111111111111111049e-01 1.111111111111111049e-01 1.111111111111111049e-01 1.111111111111111049e-01 1.111111111111111049e-01 1.111111111111111049e-01 1.111111111111111049e-01 1.111111111111111049e-01 1.111111111111111049e-01 1.111111111111111049e-01 1.111111111111111049e-01
