1.121955095442478090e+01 1.121955095442478090e+01 1.121955095442478090e+01 1.644633137689405800e+01 1.644633137689405800e+01 1.644633137689405800e+01 1.644633137689405800e+01 1.665967201206148474e+01 7.209553441603747004e+00 1.121955095442478090e+01 1.121955095442478090e+01 1.121955095442478090e+01 1.121955095442478090e+01 1.121955095442478090e+01 1.121955095442478090e+01 1.121955095442478090e+01 1.121955095442478090e+01 1.121955095442478090e+01 1.121955095442478090e+01 1.121955095442478090e+01 1.121955095442478090e+01 1.121955095442478090e+01
1.121955095442478090e+01 1.121955095442478090e+01 1.644633137689405800e+01 2.659672703989838283e+01 3.532563160005858549e+01 4.162662839166042517e+01 2.787129211445240173e+01 2.787129211445240173e+01 1.665967201206148474e+01 7.209553441603747004e+00 1.121955095442478090e+01 1.121955095442478090e+01 1.121955095442478090e+01 1.121955095442478090e+01 1.121955095442478090e+01 1.121955095442478090e+01 1.121955095442478090e+01 1.121955095442478090e+01 1.121955095442478090e+01 1.121955095442478090e+01 1.121955095442478090e+01 1.121955095442478090e+01
1.121955095442478090e+01 1.121955095442478090e+01 2.037717642487253045e+01 4.579467003790500712e+01 6.080315409467037568e+01 6.919294943923728169e+01 5.751714459293798853e+01 3.181994233636210723e+01 1.975711444369411041e+01 1.121955095442478090e+01 1.121955095442478090e+01 1.121955095442478090e+01 1.121955095442478090e+01 1.121955095442478090e+01 1.121955095442478090e+01 1.528458032503818131e+01 1.528458032503818131e+01 1.121955095442478090e+01 7.209553441603747004e+00 1.121955095442478090e+01 1.121955095442478090e+01 1.121955095442478090e+01
1.121955095442478090e+01 1.121955095442478090e+01 2.280717398950359609e+01 4.969564313733388872e+01 7.997620735131849301e+01 8.495249512773409606e+01 8.467499928512181384e+01 5.136004114645760410e+01 1.975711444369411041e+01 1.425557911201624073e+01 1.121955095442478090e+01 1.121955095442478090e+01 1.121955095442478090e+01 1.121955095442478090e+01 1.644633137689405800e+01 1.644633137689405800e+01 1.644633137689405800e+01 1.644633137689405800e+01 1.665967201206148474e+01 7.209553441603747004e+00 1.121955095442478090e+01 1.121955095442478090e+01
1.121955095442478090e+01 1.121955095442478090e+01 2.419781324283522750e+01 4.780627282951864743e+01 7.997620735131849301e+01 1.082284656810445540e+02 9.679348325111818951e+01 5.684871274836054766e+01 3.181994233636210723e+01 1.425557911201624073e+01 1.121955095442478090e+01 1.121955095442478090e+01 1.121955095442478090e+01 2.209684472610525319e+01 3.654695041814376566e+01 3.654695041814376566e+01 3.654695041814376566e+01 2.787129211445240173e+01 2.308183810282939419e+01 1.121955095442478090e+01 1.121955095442478090e+01 1.121955095442478090e+01
1.121955095442478090e+01 1.121955095442478090e+01 1.942336776676896548e+01 3.554912690624065874e+01 7.997620735131849301e+01 1.145483199540614692e+02 9.679348325111818951e+01 7.324025443754445064e+01 3.181994233636210723e+01 1.665967201206148474e+01 7.209553441603747004e+00 1.121955095442478090e+01 2.037717642487253045e+01 3.478912428802515677e+01 5.677210957559011462e+01 6.919294943923728169e+01 5.751714459293798853e+01 5.136004114645760410e+01 2.787129211445240173e+01 1.665967201206148474e+01 1.121955095442478090e+01 1.121955095442478090e+01
1.121955095442478090e+01 1.121955095442478090e+01 1.942336776676896548e+01 3.554912690624065874e+01 6.469057194781667874e+01 9.584021112571031153e+01 1.009205304437655570e+02 7.324025443754445064e+01 5.136004114645760410e+01 2.787129211445240173e+01 1.528458032503818131e+01 1.528458032503818131e+01 2.967883713856680927e+01 4.579467003790500712e+01 7.122392979906078381e+01 1.035552420320568672e+02 8.467499928512181384e+01 5.684871274836054766e+01 3.181994233636210723e+01 1.917681724224639339e+01 1.121955095442478090e+01 1.121955095442478090e+01
1.121955095442478090e+01 1.121955095442478090e+01 1.121955095442478090e+01 3.288001695737025898e+01 5.459632257191285021e+01 9.584021112571031153e+01 1.082284656810445540e+02 9.679348325111818951e+01 8.023496512233083422e+01 4.162662839166042517e+01 2.787129211445240173e+01 3.085068105621343904e+01 4.579467003790500712e+01 7.122392979906078381e+01 9.959198059926274027e+01 1.197022845618217417e+02 1.061443606170878837e+02 6.053924751424319339e+01 3.419954329141384619e+01 1.917681724224639339e+01 1.121955095442478090e+01 1.121955095442478090e+01
1.121955095442478090e+01 1.121955095442478090e+01 1.121955095442478090e+01 2.280717398950359609e+01 4.780627282951864743e+01 7.997620735131849301e+01 1.145483199540614692e+02 1.180130325396972069e+02 9.679348325111818951e+01 8.023496512233083422e+01 5.751714459293798853e+01 5.172239996095030534e+01 7.122392979906078381e+01 9.646947685620031621e+01 1.224192380358357042e+02 1.303272152808222017e+02 1.061443606170878837e+02 7.324025443754445064e+01 3.991087809466801417e+01 1.917681724224639339e+01 1.121955095442478090e+01 1.121955095442478090e+01
1.121955095442478090e+01 1.121955095442478090e+01 1.121955095442478090e+01 1.942336776676896548e+01 3.288001695737025898e+01 5.986805291352521152e+01 9.113101735609951959e+01 1.145483199540614692e+02 1.180130325396972069e+02 1.035552420320568672e+02 8.495249512773409606e+01 8.425760365659189688e+01 9.744039262810701985e+01 1.116266793638526167e+02 1.260289749346571710e+02 1.303272152808222017e+02 1.061443606170878837e+02 6.053924751424319339e+01 2.354492525521909485e+01 1.917681724224639339e+01 1.121955095442478090e+01 1.121955095442478090e+01
1.121955095442478090e+01 1.121955095442478090e+01 1.121955095442478090e+01 1.121955095442478090e+01 2.280717398950359609e+01 3.288001695737025898e+01 5.986805291352521152e+01 9.113101735609951959e+01 1.150434274277690037e+02 1.180130325396972069e+02 1.122142036274958059e+02 1.053402904041064687e+02 1.206304106454297767e+02 1.352014340952445082e+02 1.374294257164659712e+02 1.182827644967853047e+02 1.004064924351802119e+02 6.053924751424319339e+01 2.880867759680495510e+01 1.425557911201624073e+01 1.121955095442478090e+01 1.121955095442478090e+01
1.121955095442478090e+01 1.121955095442478090e+01 1.121955095442478090e+01 1.121955095442478090e+01 1.999125270553379607e+01 2.468110849245117322e+01 3.288001695737025898e+01 5.986805291352521152e+01 8.913684739421100289e+01 8.913684739421100289e+01 9.859071711769151136e+01 9.859071711769151136e+01 1.150434274277690037e+02 1.309847668534814602e+02 1.277342732513739065e+02 1.182827644967853047e+02 8.079964766481586480e+01 4.323998736967988066e+01 2.880867759680495510e+01 1.121955095442478090e+01 1.121955095442478090e+01 1.121955095442478090e+01
1.121955095442478090e+01 1.121955095442478090e+01 1.121955095442478090e+01 1.121955095442478090e+01 1.121955095442478090e+01 1.603223559861159941e+01 1.999125270553379607e+01 3.461360102871131517e+01 4.780627282951864743e+01 5.986805291352521152e+01 6.851759071353048114e+01 8.765175681606167757e+01 9.113101735609951959e+01 1.145483199540614692e+02 1.277342732513739065e+02 1.061443606170878837e+02 8.134658936811453600e+01 4.323998736967988066e+01 1.917681724224639339e+01 1.121955095442478090e+01 1.121955095442478090e+01 1.121955095442478090e+01
1.121955095442478090e+01 1.121955095442478090e+01 1.121955095442478090e+01 1.121955095442478090e+01 1.121955095442478090e+01 1.121955095442478090e+01 1.121955095442478090e+01 1.999125270553379607e+01 2.468110849245117322e+01 3.067796498705450858e+01 3.573299925653269327e+01 4.780627282951864743e+01 7.997620735131849301e+01 9.816695867705661271e+01 1.168932822954352844e+02 1.061443606170878837e+02 7.324025443754445064e+01 3.991087809466801417e+01 1.917681724224639339e+01 1.121955095442478090e+01 1.121955095442478090e+01 1.121955095442478090e+01
1.121955095442478090e+01 1.121955095442478090e+01 1.121955095442478090e+01 1.121955095442478090e+01 1.121955095442478090e+01 1.121955095442478090e+01 1.121955095442478090e+01 1.121955095442478090e+01 1.121955095442478090e+01 1.603223559861159941e+01 1.942336776676896548e+01 3.478912428802515677e+01 6.728520529699972030e+01 9.816695867705661271e+01 1.197022845618217417e+02 9.679348325111818951e+01 6.053924751424319339e+01 3.360887077606189166e+01 1.917681724224639339e+01 1.121955095442478090e+01 1.121955095442478090e+01 1.121955095442478090e+01
1.121955095442478090e+01 1.121955095442478090e+01 1.121955095442478090e+01 1.121955095442478090e+01 1.121955095442478090e+01 1.121955095442478090e+01 1.121955095442478090e+01 1.121955095442478090e+01 1.121955095442478090e+01 1.121955095442478090e+01 2.037717642487253045e+01 4.544290467840224323e+01 7.997620735131849301e+01 1.092168026050686223e+02 1.112535331985656768e+02 9.679348325111818951e+01 6.053924751424319339e+01 2.880867759680495510e+01 1.425557911201624073e+01 1.121955095442478090e+01 1.121955095442478090e+01 1.121955095442478090e+01
1.121955095442478090e+01 1.121955095442478090e+01 1.121955095442478090e+01 1.121955095442478090e+01 1.121955095442478090e+01 1.121955095442478090e+01 1.121955095442478090e+01 1.121955095442478090e+01 1.121955095442478090e+01 2.037717642487253045e+01 2.950163369822144688e+01 6.080315409467037568e+01 9.140758723063565583e+01 1.106133300385017435e+02 1.083004627430731546e+02 8.079964766481586480e+01 4.690348834788726862e+01 2.058317529991039407e+01 1.121955095442478090e+01 1.121955095442478090e+01 1.121955095442478090e+01 1.121955095442478090e+01
1.121955095442478090e+01 1.121955095442478090e+01 1.121955095442478090e+01 1.121955095442478090e+01 1.121955095442478090e+01 1.121955095442478090e+01 1.121955095442478090e+01 1.121955095442478090e+01 1.121955095442478090e+01 2.659672703989838283e+01 4.579467003790500712e+01 7.122392979906078381e+01 1.088221390271501150e+02 1.112535331985656768e+02 1.004064924351802119e+02 6.053924751424319339e+01 3.360887077606189166e+01 2.058317529991039407e+01 1.121955095442478090e+01 1.121955095442478090e+01 1.121955095442478090e+01 1.121955095442478090e+01
1.121955095442478090e+01 1.121955095442478090e+01 1.121955095442478090e+01 1.121955095442478090e+01 1.121955095442478090e+01 1.121955095442478090e+01 1.121955095442478090e+01 1.644633137689405800e+01 2.659672703989838283e+01 4.579467003790500712e+01 7.122392979906078381e+01 9.744039262810701985e+01 1.187224872198644903e+02 1.047576300415255588e+02 7.728102595773664518e+01 4.690348834788726862e+01 2.058317529991039407e+01 1.121955095442478090e+01 1.121955095442478090e+01 1.121955095442478090e+01 1.121955095442478090e+01 1.121955095442478090e+01
1.121955095442478090e+01 1.121955095442478090e+01 1.121955095442478090e+01 1.121955095442478090e+01 1.121955095442478090e+01 1.121955095442478090e+01 1.121955095442478090e+01 2.037717642487253045e+01 4.579467003790500712e+01 7.122392979906078381e+01 9.744039262810701985e+01 1.106133300385017435e+02 1.112535331985656768e+02 8.684673049553772728e+01 5.631980619761183249e+01 3.024183590589346338e+01 2.058317529991039407e+01 1.121955095442478090e+01 1.121955095442478090e+01 1.121955095442478090e+01 1.121955095442478090e+01 1.121955095442478090e+01
1.121955095442478090e+01 1.121955095442478090e+01 1.121955095442478090e+01 1.121955095442478090e+01 1.121955095442478090e+01 1.121955095442478090e+01 1.603223559861159941e+01 2.967883713856680927e+01 4.969564313733388872e+01 7.997620735131849301e+01 9.584021112571031153e+01 1.029522983091871851e+02 8.684673049553772728e+01 6.777249888936229638e+01 4.094616485398863404e+01 2.058317529991039407e+01 1.121955095442478090e+01 1.121955095442478090e+01 1.121955095442478090e+01 1.121955095442478090e+01 1.121955095442478090e+01 1.121955095442478090e+01
1.121955095442478090e+01 1.121955095442478090e+01 1.121955095442478090e+01 1.121955095442478090e+01 1.121955095442478090e+01 1.121955095442478090e+01 2.037717642487253045e+01 2.419781324283522750e+01 4.780627282951864743e+01 6.469057194781667874e+01 8.913684739421100289e+01 7.518839806447329011e+01 5.631980619761183249e+01 4.094616485398863404e+01 2.058317529991039407e+01 1.425557911201624073e+01 1.121955095442478090e+01 1.121955095442478090e+01 1.121955095442478090e+01 1.121955095442478090e+01 1.121955095442478090e+01 1.121955095442478090e+01
