1.059007280540633822e+01 1.059007280540633822e+01 1.059007280540633822e+01 1.059007280540633822e+01 1.059007280540633822e+01 1.059007280540633822e+01 1.059007280540633822e+01 1.059007280540633822e+01 1.059007280540633822e+01 1.655553419653339020e+01 2.020631289401081432e+01 2.186156241649475973e+01 2.186156241649475973e+01 2.304951340156228312e+01 1.059007280540633822e+01 1.059007280540633822e+01 1.059007280540633822e+01 1.059007280540633822e+01 1.059007280540633822e+01 1.059007280540633822e+01 1.059007280540633822e+01 1.059007280540633822e+01
1.059007280540633822e+01 1.059007280540633822e+01 1.059007280540633822e+01 1.059007280540633822e+01 1.059007280540633822e+01 1.059007280540633822e+01 1.059007280540633822e+01 1.059007280540633822e+01 2.020631289401081432e+01 2.511941430769709882e+01 3.604258471189580604e+01 4.324402516702511434e+01 4.006774007984525809e+01 2.878179404432587773e+01 2.112100310091644317e+01 1.059007280540633822e+01 1.059007280540633822e+01 1.059007280540633822e+01 1.059007280540633822e+01 1.059007280540633822e+01 1.059007280540633822e+01 1.059007280540633822e+01
1.059007280540633822e+01 1.059007280540633822e+01 1.059007280540633822e+01 1.059007280540633822e+01 1.059007280540633822e+01 1.059007280540633822e+01 1.059007280540633822e+01 2.343831291210425860e+01 3.858060145564402177e+01 4.999162775636807510e+01 5.534715119741370160e+01 7.290362102931661070e+01 7.331484543287757560e+01 5.482583155802480235e+01 4.128821503151289107e+01 2.446380806349958803e+01 2.112100310091644317e+01 1.059007280540633822e+01 1.059007280540633822e+01 1.059007280540633822e+01 1.059007280540633822e+01 1.059007280540633822e+01
1.059007280540633822e+01 1.059007280540633822e+01 1.059007280540633822e+01 1.059007280540633822e+01 1.059007280540633822e+01 1.059007280540633822e+01 2.234525990375084348e+01 3.858060145564402177e+01 5.920202410051773256e+01 7.017193168514502588e+01 7.752398993097169466e+01 8.486876374399945178e+01 7.647961763405841396e+01 7.597901642189626159e+01 6.659787043424640274e+01 4.298453589303452560e+01 3.431723930628865560e+01 2.068965660650491856e+01 1.059007280540633822e+01 1.059007280540633822e+01 1.059007280540633822e+01 1.059007280540633822e+01
1.059007280540633822e+01 1.059007280540633822e+01 1.059007280540633822e+01 1.059007280540633822e+01 1.059007280540633822e+01 1.746777158704578881e+01 2.928289735272560179e+01 5.189815474342468349e+01 7.017193168514502588e+01 8.486876374399945178e+01 7.950083520381303970e+01 7.461030726255977186e+01 7.759593677471207229e+01 9.019726423106190794e+01 8.275388559669688959e+01 7.437357104700166133e+01 5.114420120664814107e+01 2.521322112677976790e+01 1.059007280540633822e+01 1.059007280540633822e+01 1.059007280540633822e+01 1.059007280540633822e+01
1.059007280540633822e+01 1.059007280540633822e+01 1.059007280540633822e+01 1.059007280540633822e+01 1.059007280540633822e+01 2.203817407130197381e+01 4.036593061765342583e+01 6.513811703628834948e+01 7.752398993097169466e+01 7.537434021959226982e+01 6.193988267438919593e+01 4.901437079502679239e+01 5.830664859817087375e+01 8.203267464890822680e+01 9.344076234130713488e+01 8.525820998986030474e+01 5.563493727363151464e+01 3.334662995605850000e+01 1.985808619830547173e+01 1.059007280540633822e+01 1.059007280540633822e+01 1.059007280540633822e+01
1.059007280540633822e+01 1.059007280540633822e+01 1.059007280540633822e+01 1.059007280540633822e+01 1.059007280540633822e+01 2.203817407130197381e+01 3.839806761630147491e+01 6.513811703628834948e+01 8.125816198330849716e+01 7.408139922983758652e+01 4.821093298100115021e+01 3.693664574620151342e+01 5.030158609100872980e+01 7.686980701091836465e+01 8.797386269657279456e+01 7.761527331379596717e+01 5.459352565471165519e+01 2.782745922775130509e+01 1.059007280540633822e+01 1.059007280540633822e+01 1.059007280540633822e+01 1.059007280540633822e+01
1.059007280540633822e+01 1.059007280540633822e+01 1.059007280540633822e+01 1.059007280540633822e+01 1.059007280540633822e+01 2.116666946119428871e+01 3.766159943656627007e+01 6.300757927800032121e+01 7.647961763405841396e+01 7.073166298371860705e+01 5.114420120664814107e+01 4.123570614092379572e+01 6.135999229592209758e+01 8.229031409451245338e+01 7.950083520381303970e+01 6.466635262479873347e+01 4.299171655663895564e+01 2.196921211170429444e+01 1.059007280540633822e+01 1.059007280540633822e+01 1.059007280540633822e+01 1.059007280540633822e+01
1.059007280540633822e+01 1.059007280540633822e+01 1.059007280540633822e+01 1.059007280540633822e+01 1.059007280540633822e+01 2.116666946119428871e+01 3.218847632818508231e+01 5.956620707458916542e+01 8.203267464890822680e+01 7.597901642189626159e+01 7.437357104700166133e+01 6.424462203644127101e+01 7.017193168514502588e+01 7.752398993097169466e+01 6.572041151665355585e+01 5.013117464565002024e+01 3.046104290229520473e+01 1.985808619830547173e+01 1.059007280540633822e+01 1.059007280540633822e+01 1.059007280540633822e+01 1.059007280540633822e+01
1.059007280540633822e+01 1.059007280540633822e+01 1.059007280540633822e+01 1.059007280540633822e+01 1.059007280540633822e+01 1.059007280540633822e+01 2.116666946119428871e+01 3.766159943656627007e+01 6.183365341168811824e+01 9.019726423106190794e+01 8.996627041103823785e+01 8.996627041103823785e+01 8.125816198330849716e+01 7.408139922983758652e+01 5.502649077287107104e+01 3.643758600053612895e+01 2.132170013376791573e+01 1.059007280540633822e+01 1.059007280540633822e+01 1.059007280540633822e+01 1.059007280540633822e+01 1.059007280540633822e+01
1.059007280540633822e+01 1.059007280540633822e+01 1.059007280540633822e+01 1.059007280540633822e+01 1.059007280540633822e+01 1.059007280540633822e+01 2.116666946119428871e+01 2.989171542845337370e+01 5.956620707458916542e+01 8.203267464890822680e+01 9.986351761035045627e+01 1.066261018732194685e+02 9.123631858461834554e+01 7.408139922983758652e+01 4.422521858580847010e+01 2.476792985486370213e+01 1.477093330025634010e+01 1.059007280540633822e+01 1.059007280540633822e+01 1.059007280540633822e+01 1.059007280540633822e+01 1.059007280540633822e+01
1.059007280540633822e+01 1.059007280540633822e+01 1.059007280540633822e+01 1.059007280540633822e+01 1.059007280540633822e+01 1.059007280540633822e+01 1.059007280540633822e+01 2.438858320812009950e+01 4.521695829142818468e+01 7.686980701091836465e+01 1.081180632474795402e+02 1.098080770848963823e+02 9.308082787464572050e+01 6.616659472262693953e+01 3.837954943437781452e+01 1.906683777408682090e+01 1.059007280540633822e+01 1.059007280540633822e+01 1.059007280540633822e+01 1.059007280540633822e+01 1.059007280540633822e+01 1.059007280540633822e+01
1.059007280540633822e+01 1.059007280540633822e+01 1.059007280540633822e+01 1.059007280540633822e+01 1.059007280540633822e+01 1.059007280540633822e+01 1.059007280540633822e+01 2.203817407130197381e+01 4.521695829142818468e+01 7.686980701091836465e+01 9.845389015810090427e+01 1.088290956469559063e+02 9.659756387682502066e+01 6.616659472262693953e+01 3.955455334013480240e+01 2.068965660650491856e+01 1.059007280540633822e+01 1.059007280540633822e+01 1.059007280540633822e+01 1.059007280540633822e+01 1.059007280540633822e+01 1.059007280540633822e+01
1.059007280540633822e+01 1.059007280540633822e+01 1.059007280540633822e+01 1.059007280540633822e+01 1.059007280540633822e+01 1.059007280540633822e+01 1.059007280540633822e+01 2.203817407130197381e+01 4.621949210249843532e+01 7.686980701091836465e+01 8.684592840921604306e+01 1.008103163898088326e+02 8.933106369057139773e+01 6.790789668325793116e+01 5.114420120664814107e+01 2.521322112677976790e+01 1.059007280540633822e+01 1.059007280540633822e+01 1.059007280540633822e+01 1.059007280540633822e+01 1.059007280540633822e+01 1.059007280540633822e+01
1.059007280540633822e+01 1.059007280540633822e+01 1.059007280540633822e+01 1.059007280540633822e+01 1.059007280540633822e+01 1.059007280540633822e+01 1.746777158704578881e+01 2.928289735272560179e+01 4.888713506829801503e+01 6.777950708141023028e+01 7.950083520381303970e+01 7.950083520381303970e+01 7.361973835598747939e+01 7.174538477284657745e+01 5.114420120664814107e+01 3.555236649106497993e+01 2.068965660650491856e+01 1.059007280540633822e+01 1.059007280540633822e+01 1.059007280540633822e+01 1.059007280540633822e+01 1.059007280540633822e+01
1.059007280540633822e+01 1.059007280540633822e+01 1.059007280540633822e+01 1.059007280540633822e+01 1.059007280540633822e+01 1.059007280540633822e+01 2.203817407130197381e+01 3.621845238151016133e+01 5.797342249607441289e+01 6.952981230860024198e+01 6.436370233077248315e+01 6.141594349919029838e+01 6.593991110658946297e+01 7.000779893938107534e+01 6.336080593572546604e+01 4.047374110711054840e+01 2.521322112677976790e+01 1.059007280540633822e+01 1.059007280540633822e+01 1.059007280540633822e+01 1.059007280540633822e+01 1.059007280540633822e+01
1.059007280540633822e+01 1.059007280540633822e+01 1.059007280540633822e+01 1.059007280540633822e+01 1.059007280540633822e+01 1.059007280540633822e+01 2.203817407130197381e+01 3.737331766433220537e+01 5.797342249607441289e+01 6.336080593572546604e+01 5.613087520400042507e+01 4.293422073745269785e+01 5.730852893233635825e+01 6.274803992346259207e+01 7.073166298371860705e+01 5.085644369324204206e+01 2.498664701760094431e+01 1.059007280540633822e+01 1.059007280540633822e+01 1.059007280540633822e+01 1.059007280540633822e+01 1.059007280540633822e+01
1.059007280540633822e+01 1.059007280540633822e+01 1.059007280540633822e+01 1.059007280540633822e+01 1.059007280540633822e+01 1.059007280540633822e+01 2.316595673045581805e+01 4.621949210249843532e+01 5.797342249607441289e+01 6.336080593572546604e+01 5.193353628221058926e+01 3.693664574620151342e+01 4.888713506829801503e+01 6.777950708141023028e+01 7.145025987454479832e+01 4.337432000986636638e+01 2.266333497470513691e+01 1.059007280540633822e+01 1.059007280540633822e+01 1.059007280540633822e+01 1.059007280540633822e+01 1.059007280540633822e+01
1.059007280540633822e+01 1.059007280540633822e+01 1.059007280540633822e+01 1.059007280540633822e+01 1.059007280540633822e+01 1.746777158704578881e+01 2.570183523271780501e+01 4.621949210249843532e+01 6.652493916662287177e+01 7.174538477284657745e+01 5.482583155802480235e+01 5.151224669367431375e+01 6.501477632181733668e+01 6.952981230860024198e+01 6.466635262479873347e+01 4.191674276752204520e+01 2.196921211170429444e+01 1.059007280540633822e+01 1.059007280540633822e+01 1.059007280540633822e+01 1.059007280540633822e+01 1.059007280540633822e+01
1.059007280540633822e+01 1.059007280540633822e+01 1.059007280540633822e+01 1.059007280540633822e+01 1.059007280540633822e+01 1.746777158704578881e+01 2.570183523271780501e+01 4.621949210249843532e+01 6.513811703628834948e+01 7.647961763405841396e+01 7.903758591764216135e+01 7.626595947118352115e+01 6.824893807505358723e+01 7.145025987454479832e+01 5.286329606169766038e+01 3.185174047389404706e+01 1.935397328083085355e+01 1.059007280540633822e+01 1.059007280540633822e+01 1.059007280540633822e+01 1.059007280540633822e+01 1.059007280540633822e+01
1.059007280540633822e+01 1.059007280540633822e+01 1.059007280540633822e+01 1.059007280540633822e+01 1.059007280540633822e+01 1.059007280540633822e+01 2.438858320812009950e+01 4.735107366498647963e+01 7.262139152702894762e+01 9.019726423106190794e+01 8.403032843992511403e+01 8.403032843992511403e+01 7.145025987454479832e+01 5.613087520400042507e+01 3.643758600053612895e+01 2.132170013376791573e+01 1.477093330025634010e+01 1.059007280540633822e+01 1.059007280540633822e+01 1.059007280540633822e+01 1.059007280540633822e+01 1.059007280540633822e+01
1.059007280540633822e+01 1.059007280540633822e+01 1.059007280540633822e+01 1.059007280540633822e+01 1.059007280540633822e+01 1.059007280540633822e+01 2.116666946119428871e+01 3.766159943656627007e+01 5.830664859817087375e+01 6.710857019980522864e+01 7.824784820606943470e+01 7.581138759358364609e+01 5.728341817169241068e+01 4.071593117746377999e+01 2.613463092226445994e+01 1.477093330025634010e+01 1.059007280540633822e+01 1.059007280540633822e+01 1.059007280540633822e+01 1.059007280540633822e+01 1.059007280540633822e+01 1.059007280540633822e+01
