1.049587658180454675e+01 1.049587658180454675e+01 1.049587658180454675e+01 1.049587658180454675e+01 1.049587658180454675e+01 1.049587658180454675e+01 1.991310736778258672e+01 2.402260654273660379e+01 3.604258471189580604e+01 4.840246367611762679e+01 5.534715119741370160e+01 5.792027839251110777e+01 5.792027839251110777e+01 5.162282319978789502e+01 3.769266979682478080e+01 2.446778686296064009e+01 1.902653654378126191e+01 1.049587658180454675e+01 1.049587658180454675e+01 1.049587658180454675e+01 1.049587658180454675e+01 1.049587658180454675e+01
1.049587658180454675e+01 1.049587658180454675e+01 1.049587658180454675e+01 1.049587658180454675e+01 1.049587658180454675e+01 1.745892276844493196e+01 2.524706658916216639e+01 4.633192310790022361e+01 6.449574610260309271e+01 8.017638456827901905e+01 8.521440792603327452e+01 9.519453499090872128e+01 8.952963988609276669e+01 7.882506888120558131e+01 7.033280077259063034e+01 4.643157282265079999e+01 2.394983016203091353e+01 1.049587658180454675e+01 1.049587658180454675e+01 1.049587658180454675e+01 1.049587658180454675e+01 1.049587658180454675e+01
1.049587658180454675e+01 1.049587658180454675e+01 1.049587658180454675e+01 1.049587658180454675e+01 1.049587658180454675e+01 1.932788566997604462e+01 3.592354097194406393e+01 6.076263038747750755e+01 8.508801691092897101e+01 1.044625616042773686e+02 1.131951901395395907e+02 1.093977902179877617e+02 1.119837381509712202e+02 1.071515851078959543e+02 9.013486743869660245e+01 6.524057517551891294e+01 3.955455334013480240e+01 2.013145738725555489e+01 1.049587658180454675e+01 1.049587658180454675e+01 1.049587658180454675e+01 1.049587658180454675e+01
1.049587658180454675e+01 1.049587658180454675e+01 1.049587658180454675e+01 1.049587658180454675e+01 1.049587658180454675e+01 2.015026756361512739e+01 3.736419666824448882e+01 6.667787997409557477e+01 9.606868795339896394e+01 1.056331118742211004e+02 1.009299374545850299e+02 1.020859546958443502e+02 1.034888002628461123e+02 1.115162556988220359e+02 1.024932893535961256e+02 8.241584257593706297e+01 5.487634782173083181e+01 2.567015351301001758e+01 1.049587658180454675e+01 1.049587658180454675e+01 1.049587658180454675e+01 1.049587658180454675e+01
1.049587658180454675e+01 1.049587658180454675e+01 1.049587658180454675e+01 1.049587658180454675e+01 1.049587658180454675e+01 2.015026756361512739e+01 3.218521842226653717e+01 4.996477788781766094e+01 6.520853516644879733e+01 7.967645822030814884e+01 7.073517043085645639e+01 6.815687936568926375e+01 7.818406345734186402e+01 9.877913934965933151e+01 1.102358725322514488e+02 9.573978947863190569e+01 6.421218164412613305e+01 3.156765115676046918e+01 1.470065605582684753e+01 1.049587658180454675e+01 1.049587658180454675e+01 1.049587658180454675e+01
1.049587658180454675e+01 1.049587658180454675e+01 1.049587658180454675e+01 1.049587658180454675e+01 1.049587658180454675e+01 1.049587658180454675e+01 2.323018878019807687e+01 3.466447217527978353e+01 3.925372453970049236e+01 4.908865236562887446e+01 4.293556731489845646e+01 4.248868793188598403e+01 6.186422396667725820e+01 8.504925111423925443e+01 1.088015873682298462e+02 9.443986208850006392e+01 6.399528531501141515e+01 3.156765115676046918e+01 1.935590519696998868e+01 1.049587658180454675e+01 1.049587658180454675e+01 1.049587658180454675e+01
1.049587658180454675e+01 1.049587658180454675e+01 1.049587658180454675e+01 1.049587658180454675e+01 1.049587658180454675e+01 1.049587658180454675e+01 1.049587658180454675e+01 2.115019314448392507e+01 2.519624503170420837e+01 2.583691821299094116e+01 3.148223429879864810e+01 4.478423062541608601e+01 7.245383298925598581e+01 9.889320879486335514e+01 1.169344510286453271e+02 1.036852819067594993e+02 6.616659472262693953e+01 3.447532975372389785e+01 1.935590519696998868e+01 1.049587658180454675e+01 1.049587658180454675e+01 1.049587658180454675e+01
1.049587658180454675e+01 1.049587658180454675e+01 1.049587658180454675e+01 1.049587658180454675e+01 1.049587658180454675e+01 1.049587658180454675e+01 1.991310736778258672e+01 2.033813614312694185e+01 3.051153220209226191e+01 4.159784653436095425e+01 5.378170764094701894e+01 7.788340123614727872e+01 9.744039262810701985e+01 1.113627249291354815e+02 1.205583537524008619e+02 1.036852819067594993e+02 7.324171881884836921e+01 3.452300160336277202e+01 1.906548892319178989e+01 1.049587658180454675e+01 1.049587658180454675e+01 1.049587658180454675e+01
1.049587658180454675e+01 1.049587658180454675e+01 1.049587658180454675e+01 1.049587658180454675e+01 1.049587658180454675e+01 2.033813614312694185e+01 3.051153220209226191e+01 4.202254831522960643e+01 6.319434255026437341e+01 8.017638456827901905e+01 8.837243389603352739e+01 1.059909844432770569e+02 1.202340611812947913e+02 1.350542072522559920e+02 1.302257866101182913e+02 1.144392194768032027e+02 7.839936863692764746e+01 4.551098033406847776e+01 2.046724206577894023e+01 1.049587658180454675e+01 1.049587658180454675e+01 1.049587658180454675e+01
1.049587658180454675e+01 1.049587658180454675e+01 1.049587658180454675e+01 1.049587658180454675e+01 2.043930303101348755e+01 3.232573919319023759e+01 5.920202410051773256e+01 7.795595594338149681e+01 9.835894512594049388e+01 1.088570908412267073e+02 1.202340611812947913e+02 1.233952274763904171e+02 1.380705037790083054e+02 1.380705037790083054e+02 1.320356343633408756e+02 1.236017888342805122e+02 8.241584257593706297e+01 5.487634782173083181e+01 2.567015351301001758e+01 1.049587658180454675e+01 1.049587658180454675e+01 1.049587658180454675e+01
1.049587658180454675e+01 1.049587658180454675e+01 1.049587658180454675e+01 1.049587658180454675e+01 2.487014464207499742e+01 4.956987567206795120e+01 7.387507198987125889e+01 1.049830909934484140e+02 1.211693705862510626e+02 1.248516934835270149e+02 1.246182494969465893e+02 1.217130681857276073e+02 1.183614542096221811e+02 1.272384443420621665e+02 1.272384443420621665e+02 1.236017888342805122e+02 9.573978947863190569e+01 6.421218164412613305e+01 3.156765115676046918e+01 1.470065605582684753e+01 1.049587658180454675e+01 1.049587658180454675e+01
1.049587658180454675e+01 1.049587658180454675e+01 1.049587658180454675e+01 1.745892276844493196e+01 2.435920895946700071e+01 5.300240191720465077e+01 8.907631703346606855e+01 1.056331118742211004e+02 1.154877297275977526e+02 1.183614542096221811e+02 1.009434562057535913e+02 8.757251443776908673e+01 9.502585619177121146e+01 1.020859546958443502e+02 1.145710934497178926e+02 1.222726101420641243e+02 1.017483633972080384e+02 6.616659472262693953e+01 3.156765115676046918e+01 1.935590519696998868e+01 1.049587658180454675e+01 1.049587658180454675e+01
1.049587658180454675e+01 1.049587658180454675e+01 1.049587658180454675e+01 1.049587658180454675e+01 2.440327033244665955e+01 4.996477788781766094e+01 6.520853516644879733e+01 8.250853467910826566e+01 7.967645822030814884e+01 8.250853467910826566e+01 6.802219923331432483e+01 6.547501984676775066e+01 6.504298621570063688e+01 7.608557172103523669e+01 1.031843487912217938e+02 1.148484768703612389e+02 1.033158869828793485e+02 6.616659472262693953e+01 3.447532975372389785e+01 1.935590519696998868e+01 1.049587658180454675e+01 1.049587658180454675e+01
1.049587658180454675e+01 1.049587658180454675e+01 1.049587658180454675e+01 1.049587658180454675e+01 2.323018878019807687e+01 2.901029638712745751e+01 4.615947559395595334e+01 5.037006228431695831e+01 5.281984020578320127e+01 4.908865236562887446e+01 4.352539073803197311e+01 3.867588332652246663e+01 4.780811251532192330e+01 7.616250887174561512e+01 1.005806623717835606e+02 1.171323025916975240e+02 9.443986208850006392e+01 6.439859456736296295e+01 3.164748180427212176e+01 1.470065605582684753e+01 1.049587658180454675e+01 1.049587658180454675e+01
1.049587658180454675e+01 1.049587658180454675e+01 1.049587658180454675e+01 1.049587658180454675e+01 1.049587658180454675e+01 2.115019314448392507e+01 2.021653688714377139e+01 2.579756240116949328e+01 2.863306196066779208e+01 2.575741534881093031e+01 2.519624503170420837e+01 3.760376993283141900e+01 5.386683122221396758e+01 8.315498382471247396e+01 1.085772914391396711e+02 1.098355073096574870e+02 8.707955050475825942e+01 5.434039287347142277e+01 2.690483528984408679e+01 1.049587658180454675e+01 1.049587658180454675e+01 1.049587658180454675e+01
1.049587658180454675e+01 1.049587658180454675e+01 1.049587658180454675e+01 1.049587658180454675e+01 1.049587658180454675e+01 1.602449089389737935e+01 1.602449089389737935e+01 1.703250329080236014e+01 2.066747806616313099e+01 2.205342545170306323e+01 3.051153220209226191e+01 4.633192310790022361e+01 7.245383298925598581e+01 1.049830909934484140e+02 1.139101774653244945e+02 1.033158869828793485e+02 7.423607157678026169e+01 4.212828744782621726e+01 2.023778319101004541e+01 1.049587658180454675e+01 1.049587658180454675e+01 1.049587658180454675e+01
1.049587658180454675e+01 1.049587658180454675e+01 1.991310736778258672e+01 2.135024088547363164e+01 2.538074916777209467e+01 2.842362861704922850e+01 2.842362861704922850e+01 2.830120131461937660e+01 3.016526386525699976e+01 4.159784653436095425e+01 5.378170764094701894e+01 8.398778897932785981e+01 1.001562787429639627e+02 1.131951901395395907e+02 1.101816711259983919e+02 8.579133706207525734e+01 5.238529566916119506e+01 3.057174326968897304e+01 1.986423608768883753e+01 1.049587658180454675e+01 1.049587658180454675e+01 1.049587658180454675e+01
1.049587658180454675e+01 2.043930303101348755e+01 3.232573919319023759e+01 4.756463616943907624e+01 5.534715119741370160e+01 5.792027839251110777e+01 5.792027839251110777e+01 5.792027839251110777e+01 6.607589180596177414e+01 7.788340123614727872e+01 8.849463623698140680e+01 1.049830909934484140e+02 1.139101774653244945e+02 1.078960028171675560e+02 8.878914915516438100e+01 6.219682645878923211e+01 3.685701308581954549e+01 2.265888902225694324e+01 1.049587658180454675e+01 1.049587658180454675e+01 1.049587658180454675e+01 1.049587658180454675e+01
1.049587658180454675e+01 2.487014464207499742e+01 4.670315461909069654e+01 7.059158386113450945e+01 8.837243389603352739e+01 9.519453499090872128e+01 9.519453499090872128e+01 9.519453499090872128e+01 9.672085249771242843e+01 1.001562787429639627e+02 1.131951901395395907e+02 1.141599525798268928e+02 1.009299374545850299e+02 8.672386409757240244e+01 6.219682645878923211e+01 3.939414885271118294e+01 2.272650440589485754e+01 1.581130115740249842e+01 1.049587658180454675e+01 1.049587658180454675e+01 1.049587658180454675e+01 1.049587658180454675e+01
1.745892276844493196e+01 2.964090235024836417e+01 5.402963108607035991e+01 8.724990224384166027e+01 1.043544357679756729e+02 1.093977902179877617e+02 1.129828633484956839e+02 1.129828633484956839e+02 1.078002916555558102e+02 1.052333821813460304e+02 1.009299374545850299e+02 9.868036232457166079e+01 7.755118672539367708e+01 5.665476014420391238e+01 3.939414885271118294e+01 2.272650440589485754e+01 1.581130115740249842e+01 1.049587658180454675e+01 1.049587658180454675e+01 1.049587658180454675e+01 1.049587658180454675e+01 1.049587658180454675e+01
1.049587658180454675e+01 2.440327033244665955e+01 4.996477788781766094e+01 6.520853516644879733e+01 9.133264399004667666e+01 9.502585619177121146e+01 9.502585619177121146e+01 9.475486267545113606e+01 7.967645822030814884e+01 8.250853467910826566e+01 7.073517043085645639e+01 6.547501984676775066e+01 4.352539073803197311e+01 3.460588466971056221e+01 2.272650440589485754e+01 1.581130115740249842e+01 1.049587658180454675e+01 1.049587658180454675e+01 1.049587658180454675e+01 1.049587658180454675e+01 1.049587658180454675e+01 1.049587658180454675e+01
1.049587658180454675e+01 2.115019314448392507e+01 2.901029638712745751e+01 4.725425585536513751e+01 5.624953753928834033e+01 6.547501984676775066e+01 6.547501984676775066e+01 5.624953753928834033e+01 5.281984020578320127e+01 4.908865236562887446e+01 4.352539073803197311e+01 3.460588466971056221e+01 2.272650440589485754e+01 2.079276208285052263e+01 1.049587658180454675e+01 1.049587658180454675e+01 1.049587658180454675e+01 1.049587658180454675e+01 1.049587658180454675e+01 1.049587658180454675e+01 1.049587658180454675e+01 1.049587658180454675e+01
