5.864103223593963854e-01 5.864103223593963854e-01 5.864103223593963854e-01 5.864103223593963854e-01 7.563271604938271997e-01 1.832741781761381139e+00 1.635438938740562120e+00 1.531800555023214772e+00 1.481574737733978520e+00 1.408195651755201228e+00 1.431338366473970281e+00 1.531800555023214772e+00 1.342696858857270303e+00 1.398608735436374317e+00 1.405159803696035770e+00 1.009623094175419622e+00 1.342696858857270303e+00 1.401280161806324642e+00 1.448284394189816027e+00 1.593848482766635044e+00 5.864103223593963854e-01 5.864103223593963854e-01
5.864103223593963854e-01 5.864103223593963854e-01 5.864103223593963854e-01 5.864103223593963854e-01 7.025718694885362270e-01 1.119177216167768441e+00 1.180891528733458706e+00 1.481574737733978520e+00 1.639920954702635880e+00 1.715544144554230543e+00 1.724052894849265050e+00 1.957776864088232482e+00 1.493365465960169391e+00 1.398608735436374317e+00 1.180891528733458706e+00 1.180891528733458706e+00 1.342696858857270303e+00 1.342696858857270303e+00 1.337041536807901831e+00 1.401280161806324642e+00 1.405159803696035770e+00 5.864103223593963854e-01
5.864103223593963854e-01 5.864103223593963854e-01 5.864103223593963854e-01 5.864103223593963854e-01 5.864103223593963854e-01 1.180891528733458706e+00 1.546601488402492786e+00 1.534995867825748483e+00 1.448284394189816027e+00 1.593848482766635044e+00 1.819399392899718082e+00 1.405159803696035770e+00 1.493365465960169391e+00 1.283476738375510795e+00 1.180891528733458706e+00 1.180891528733458706e+00 1.297438915607981302e+00 1.283958385341307906e+00 1.546601488402492786e+00 1.546601488402492786e+00 1.448284394189816027e+00 5.864103223593963854e-01
5.864103223593963854e-01 5.864103223593963854e-01 5.864103223593963854e-01 5.864103223593963854e-01 7.025718694885362270e-01 1.342696858857270303e+00 1.342696858857270303e+00 1.796394991142466813e+00 1.481574737733978520e+00 1.493365465960169391e+00 1.715544144554230543e+00 1.394990259987054504e+00 1.546601488402492786e+00 1.394860076800541027e+00 1.396955483262673381e+00 1.337041536807901831e+00 1.194479276895943354e+00 7.563271604938271997e-01 1.796394991142466813e+00 1.342696858857270303e+00 1.297438915607981302e+00 5.864103223593963854e-01
5.864103223593963854e-01 7.563271604938271997e-01 5.864103223593963854e-01 5.864103223593963854e-01 7.563271604938271997e-01 9.369671274679511885e-01 1.094513261071400567e+00 1.514792010508462017e+00 1.415173716450336627e+00 1.546601488402492786e+00 1.581725009827453787e+00 1.283958385341307906e+00 1.394860076800541027e+00 1.094513261071400567e+00 1.673073015453906631e+00 1.342696858857270303e+00 1.448284394189816027e+00 2.520756205373374303e+00 2.329930215440687569e+00 1.119177216167768441e+00 1.194479276895943354e+00 9.369671274679511885e-01
5.864103223593963854e-01 1.180891528733458706e+00 1.180891528733458706e+00 1.071660523593004122e+00 7.563271604938271997e-01 4.510519593253968118e+00 4.687937865090762379e+00 1.534995867825748483e+00 1.534995867825748483e+00 1.394860076800541027e+00 1.361572140077200288e+00 1.283958385341307906e+00 1.094513261071400567e+00 1.398608735436374317e+00 1.605779799721876566e+00 1.546601488402492786e+00 2.393030453539049418e+00 4.283696269351256092e+01 3.714829423925278462e+01 1.237976190476190341e+00 1.194479276895943354e+00 5.864103223593963854e-01
9.369671274679511885e-01 9.348875041229920413e-01 1.401280161806324642e+00 1.173069761025371083e+00 7.563271604938271997e-01 4.250042817974593135e+01 2.319380089301797288e+00 1.639920954702635880e+00 1.493365465960169391e+00 1.283476738375510795e+00 1.180891528733458706e+00 7.563271604938271997e-01 1.829033344799299687e+00 1.534995867825748483e+00 1.448284394189816027e+00 1.283958385341307906e+00 5.554239303643735326e+01 5.554239303643735326e+01 6.674868539236676668e+01 2.241508035839006041e+00 1.194479276895943354e+00 5.864103223593963854e-01
1.041908095358436315e+00 1.477153684107387566e+00 1.477375116086301343e+00 2.590039413235343257e+00 1.509772506682844195e+01 1.796394991142466813e+00 1.804005293176868863e+00 1.639920954702635880e+00 1.546601488402492786e+00 1.394990259987054504e+00 1.448284394189816027e+00 1.506061523347361319e+00 1.376239447755261525e+00 1.342696858857270303e+00 1.756698184791934736e+01 4.283696269351256092e+01 1.665612171260808054e+02 1.664820817277029619e+02 6.706471388902102149e+01 1.398608735436374317e+00 5.864103223593963854e-01 7.025718694885362270e-01
1.724052894849265050e+00 1.327643550506185210e+00 1.546601488402492786e+00 1.633953637566137429e+00 2.110572703686387186e+01 1.488831689590789598e+00 1.398608735436374317e+00 1.605779799721876566e+00 1.569115990699413876e+00 1.593848482766635044e+00 1.405159803696035770e+00 1.593848482766635044e+00 1.819399392899718082e+00 1.283958385341307906e+00 4.283696269351256092e+01 1.665612171260808054e+02 1.664820817277029619e+02 1.655271863797292156e+02 1.908401684431262568e+00 1.401280161806324642e+00 1.297438915607981302e+00 7.563271604938271997e-01
1.796394991142466813e+00 1.394990259987054504e+00 1.509772506682844195e+01 4.873687137716461848e+01 4.250042817974593135e+01 1.796394991142466813e+00 1.673073015453906631e+00 1.546601488402492786e+00 1.639920954702635880e+00 1.546601488402492786e+00 1.682625380166022033e+00 1.793828834488985668e+00 1.715544144554230543e+00 4.283696269351256092e+01 1.670544898221634185e+02 1.664820817277029619e+02 1.620581150729159106e+02 4.250042817974593135e+01 1.493365465960169391e+00 1.180891528733458706e+00 1.071660523593004122e+00 7.563271604938271997e-01
1.531800555023214772e+00 1.569115990699413876e+00 4.283696269351256092e+01 9.839016102176738343e+01 6.290914066739252775e+01 1.488831689590789598e+00 1.648714146800143610e+00 1.635438938740562120e+00 1.398608735436374317e+00 1.581725009827453787e+00 1.546601488402492786e+00 1.567453944422598333e+00 4.339045047031157765e+01 8.325483942329367437e+01 1.458062364035809537e+02 1.655271863797292156e+02 8.271034589865134024e+01 1.908401684431262568e+00 1.283476738375510795e+00 1.171223513775203173e+00 5.864103223593963854e-01 7.025718694885362270e-01
1.604981028584429703e+00 1.448284394189816027e+00 4.341516556437389340e+01 1.570669561017746787e+02 1.204298639195127691e+02 3.017056769233369629e+00 2.537620824380712570e+00 1.546601488402492786e+00 1.342696858857270303e+00 2.393030453539049418e+00 4.510519593253968118e+00 6.131871453079215684e+01 4.029060287039555277e+01 7.537297677722457934e+01 1.022092943121693054e+02 5.042946879588058096e+01 3.225604555971498311e+00 1.398608735436374317e+00 1.401280161806324642e+00 1.194479276895943354e+00 9.369671274679511885e-01 5.864103223593963854e-01
1.803511643946359211e+00 1.645701340085237163e+00 6.116351621048082876e+01 6.800467219721782897e+01 1.660737743991824402e+02 7.236262296479482359e+01 1.567453944422598333e+00 4.873687137716461848e+01 2.204065792596248130e+01 9.830381640443701485e+01 5.827039785102990521e+01 1.180891528733458706e+00 2.045304514478513269e+01 2.299430859629890378e+01 6.123185020494434383e+01 4.159642009828250764e+01 2.329930215440687569e+00 1.396955483262673381e+00 1.376239447755261525e+00 1.194479276895943354e+00 9.369671274679511885e-01 5.864103223593963854e-01
2.319380089301797288e+00 1.633953637566137429e+00 1.431338366473970281e+00 1.509772506682844195e+01 1.457843147062149001e+02 1.055905288879672099e+02 2.738414544112218252e+01 1.490589713485640289e+01 6.160179966452889033e+01 1.180891528733458706e+00 2.091709044283997176e+00 2.091709044283997176e+00 2.581242562458820000e+00 2.125829714138741977e+01 3.400717216599787207e+01 3.416506932285821030e+00 2.889550611311936912e+00 1.401280161806324642e+00 1.405159803696035770e+00 1.171223513775203173e+00 5.864103223593963854e-01 5.864103223593963854e-01
1.997328622435447842e+00 1.832741781761381139e+00 1.819399392899718082e+00 5.360201608073906243e+01 1.180891528733458706e+00 1.180891528733458706e+00 1.327643550506185210e+00 1.180891528733458706e+00 1.180891528733458706e+00 1.180891528733458706e+00 1.180891528733458706e+00 1.405159803696035770e+00 1.801964472879553414e+00 4.000285068203516481e+00 6.131871453079215684e+01 7.684695004358954584e+00 1.493365465960169391e+00 1.342696858857270303e+00 1.481574737733978520e+00 1.472856846958441546e+00 1.405159803696035770e+00 7.025718694885362270e-01
1.180891528733458706e+00 1.327643550506185210e+00 1.645701340085237163e+00 2.319380089301797288e+00 1.493365465960169391e+00 1.327643550506185210e+00 1.286818453262334572e+00 1.180891528733458706e+00 1.180891528733458706e+00 1.546601488402492786e+00 1.546601488402492786e+00 1.394860076800541027e+00 1.431338366473970281e+00 3.722793270767845542e+01 4.250042817974593135e+01 2.329930215440687569e+00 1.673073015453906631e+00 1.546601488402492786e+00 1.639920954702635880e+00 1.394860076800541027e+00 9.542336628736156623e-01 7.025718694885362270e-01
1.401280161806324642e+00 1.283476738375510795e+00 1.180891528733458706e+00 1.180891528733458706e+00 1.645701340085237163e+00 1.546601488402492786e+00 1.237976190476190341e+00 1.173069761025371083e+00 9.838274337348410503e-01 1.036331356096759526e+00 1.344120889487414150e+00 1.819399392899718082e+00 1.715544144554230543e+00 4.250042817974593135e+01 2.319380089301797288e+00 2.207196779168923317e+00 1.648714146800143610e+00 1.819399392899718082e+00 1.819399392899718082e+00 1.715544144554230543e+00 5.864103223593963854e-01 7.563271604938271997e-01
1.401280161806324642e+00 1.361572140077200288e+00 1.394990259987054504e+00 1.858739182545980917e+00 1.493365465960169391e+00 1.361572140077200288e+00 1.342696858857270303e+00 1.342696858857270303e+00 1.472856846958441546e+00 1.398608735436374317e+00 1.593848482766635044e+00 1.569115990699413876e+00 7.563271604938271997e-01 3.400717216599787207e+01 1.796394991142466813e+00 1.803511643946359211e+00 1.832741781761381139e+00 1.796394991142466813e+00 1.605779799721876566e+00 9.542336628736156623e-01 7.025718694885362270e-01 7.563271604938271997e-01
1.342696858857270303e+00 1.394860076800541027e+00 1.372165173707753594e+00 1.431338366473970281e+00 1.429708232990234640e+00 1.180891528733458706e+00 1.180891528733458706e+00 1.639920954702635880e+00 1.605779799721876566e+00 1.401280161806324642e+00 1.394990259987054504e+00 1.715544144554230543e+00 6.116351621048082876e+01 8.271034589865134024e+01 3.404106577249806520e+01 1.796394991142466813e+00 1.819399392899718082e+00 1.546601488402492786e+00 1.237976190476190341e+00 9.542336628736156623e-01 9.369671274679511885e-01 7.563271604938271997e-01
1.342696858857270303e+00 1.342696858857270303e+00 1.441901485619116796e+00 1.546601488402492786e+00 1.237976190476190341e+00 1.394990259987054504e+00 1.401280161806324642e+00 1.394990259987054504e+00 1.639920954702635880e+00 1.394860076800541027e+00 1.337041536807901831e+00 1.431338366473970281e+00 4.357405196296218719e+01 5.137139403292182038e+01 1.908401684431262568e+00 1.481574737733978520e+00 1.793828834488985668e+00 1.546601488402492786e+00 1.342696858857270303e+00 1.194479276895943354e+00 7.025718694885362270e-01 7.025718694885362270e-01
5.864103223593963854e-01 5.864103223593963854e-01 5.864103223593963854e-01 5.864103223593963854e-01 1.546601488402492786e+00 1.534995867825748483e+00 1.448284394189816027e+00 1.342696858857270303e+00 1.441901485619116796e+00 1.639920954702635880e+00 1.448284394189816027e+00 1.405159803696035770e+00 8.450707595053524201e+00 2.319380089301797288e+00 1.796394991142466813e+00 1.796394991142466813e+00 1.405159803696035770e+00 1.804005293176868863e+00 1.645701340085237163e+00 5.864103223593963854e-01 5.864103223593963854e-01 5.864103223593963854e-01
5.864103223593963854e-01 5.864103223593963854e-01 5.864103223593963854e-01 5.864103223593963854e-01 7.025718694885362270e-01 1.342696858857270303e+00 1.283958385341307906e+00 5.864103223593963854e-01 1.546601488402492786e+00 1.546601488402492786e+00 1.394860076800541027e+00 1.432967652893277544e+00 2.329930215440687569e+00 1.327643550506185210e+00 2.889550611311936912e+00 1.481574737733978520e+00 1.398608735436374317e+00 1.405159803696035770e+00 1.180891528733458706e+00 1.180891528733458706e+00 7.563271604938271997e-01 5.864103223593963854e-01
