1.109903316849568711e+01 1.109903316849568711e+01 1.109903316849568711e+01 1.109903316849568711e+01 1.109903316849568711e+01 1.109903316849568711e+01 1.109903316849568711e+01 1.109903316849568711e+01 2.037717642487253045e+01 4.150294799330460194e+01 6.495115162315998703e+01 8.489667067689202895e+01 9.676757172116708716e+01 7.324025443754445064e+01 5.575513865545934067e+01 3.181994233636210723e+01 1.526605552196771676e+01 1.109903316849568711e+01 1.109903316849568711e+01 1.109903316849568711e+01 1.109903316849568711e+01 1.109903316849568711e+01
1.109903316849568711e+01 1.109903316849568711e+01 1.109903316849568711e+01 1.109903316849568711e+01 1.109903316849568711e+01 1.109903316849568711e+01 1.109903316849568711e+01 1.109903316849568711e+01 2.576633043611174045e+01 5.952074275146134852e+01 8.489667067689202895e+01 1.114666628562719239e+02 1.143498999771376390e+02 8.837274307848490196e+01 4.365723699118742474e+01 2.885164208177767264e+01 1.431094522473700081e+01 1.109903316849568711e+01 1.109903316849568711e+01 1.109903316849568711e+01 1.109903316849568711e+01 1.109903316849568711e+01
1.109903316849568711e+01 1.109903316849568711e+01 1.109903316849568711e+01 1.109903316849568711e+01 1.109903316849568711e+01 1.109903316849568711e+01 1.109903316849568711e+01 2.349245159371281488e+01 4.920320029178432719e+01 7.093071908500694178e+01 1.114666628562719239e+02 1.143498999771376390e+02 1.047576300415255588e+02 7.324025443754445064e+01 4.365723699118742474e+01 2.222875414701623242e+01 1.109903316849568711e+01 1.109903316849568711e+01 1.109903316849568711e+01 1.109903316849568711e+01 1.109903316849568711e+01 1.109903316849568711e+01
1.109903316849568711e+01 1.109903316849568711e+01 1.109903316849568711e+01 1.109903316849568711e+01 1.109903316849568711e+01 1.109903316849568711e+01 2.037717642487253045e+01 2.576633043611174045e+01 6.495115162315998703e+01 9.676757172116708716e+01 1.176666978393247263e+02 1.143498999771376390e+02 9.231124431282565013e+01 4.061688066462621549e+01 2.885164208177767264e+01 1.431094522473700081e+01 1.109903316849568711e+01 1.109903316849568711e+01 1.109903316849568711e+01 1.109903316849568711e+01 1.109903316849568711e+01 1.109903316849568711e+01
1.109903316849568711e+01 1.109903316849568711e+01 1.109903316849568711e+01 1.109903316849568711e+01 1.109903316849568711e+01 1.109903316849568711e+01 2.576633043611174045e+01 4.920320029178432719e+01 8.489667067689202895e+01 1.114666628562719239e+02 1.143498999771376390e+02 1.047576300415255588e+02 7.324025443754445064e+01 4.365723699118742474e+01 2.222875414701623242e+01 1.109903316849568711e+01 1.109903316849568711e+01 1.109903316849568711e+01 1.109903316849568711e+01 1.109903316849568711e+01 1.109903316849568711e+01 1.109903316849568711e+01
1.109903316849568711e+01 1.109903316849568711e+01 1.109903316849568711e+01 1.109903316849568711e+01 1.109903316849568711e+01 2.037717642487253045e+01 2.576633043611174045e+01 6.495115162315998703e+01 9.676757172116708716e+01 1.176666978393247263e+02 1.047576300415255588e+02 9.231124431282565013e+01 5.366949246511718030e+01 2.885164208177767264e+01 1.604969362477619654e+01 1.645517789146269649e+01 1.645517789146269649e+01 1.645517789146269649e+01 1.526605552196771676e+01 1.109903316849568711e+01 1.109903316849568711e+01 1.109903316849568711e+01
1.109903316849568711e+01 1.109903316849568711e+01 1.109903316849568711e+01 1.109903316849568711e+01 1.109903316849568711e+01 2.576633043611174045e+01 4.920320029178432719e+01 7.093071908500694178e+01 1.082284656810445540e+02 1.143498999771376390e+02 1.047576300415255588e+02 7.324025443754445064e+01 4.061688066462621549e+01 2.349245159371281488e+01 3.085068105621343904e+01 3.085068105621343904e+01 3.085068105621343904e+01 2.935265923284759992e+01 1.919573249691005401e+01 1.526605552196771676e+01 1.109903316849568711e+01 1.109903316849568711e+01
1.109903316849568711e+01 1.109903316849568711e+01 1.109903316849568711e+01 1.109903316849568711e+01 1.109903316849568711e+01 2.576633043611174045e+01 6.495115162315998703e+01 9.913832126014159485e+01 1.176666978393247263e+02 1.143498999771376390e+02 9.231124431282565013e+01 5.575513865545934067e+01 4.150294799330460194e+01 4.150294799330460194e+01 5.952074275146134852e+01 7.093071908500694178e+01 7.723068726191070255e+01 5.575513865545934067e+01 3.423063199521688915e+01 1.919573249691005401e+01 1.109903316849568711e+01 1.109903316849568711e+01
1.109903316849568711e+01 1.109903316849568711e+01 1.109903316849568711e+01 1.109903316849568711e+01 2.037717642487253045e+01 4.150294799330460194e+01 7.093071908500694178e+01 1.082284656810445540e+02 1.143498999771376390e+02 1.047576300415255588e+02 7.324025443754445064e+01 5.575513865545934067e+01 5.952074275146134852e+01 7.093071908500694178e+01 8.489667067689202895e+01 1.035552420320568672e+02 1.035552420320568672e+02 7.723068726191070255e+01 5.575513865545934067e+01 3.423063199521688915e+01 1.919573249691005401e+01 1.109903316849568711e+01
1.109903316849568711e+01 1.109903316849568711e+01 1.109903316849568711e+01 1.109903316849568711e+01 2.576633043611174045e+01 4.920320029178432719e+01 9.067636944300858204e+01 1.227650644017196271e+02 1.143498999771376390e+02 1.062785400205577133e+02 7.324025443754445064e+01 7.093071908500694178e+01 8.489667067689202895e+01 1.035552420320568672e+02 1.114666628562719239e+02 1.196588587051189734e+02 1.184030477988119969e+02 1.184030477988119969e+02 8.837274307848490196e+01 5.575513865545934067e+01 2.439381968786790367e+01 1.109903316849568711e+01
1.109903316849568711e+01 1.109903316849568711e+01 1.109903316849568711e+01 2.037717642487253045e+01 2.576633043611174045e+01 6.495115162315998703e+01 9.676757172116708716e+01 1.176666978393247263e+02 1.143498999771376390e+02 9.231124431282565013e+01 7.723068726191070255e+01 8.489667067689202895e+01 1.114666628562719239e+02 1.206223654132282377e+02 1.250020922091338065e+02 1.369383854450178148e+02 1.369383854450178148e+02 1.184030477988119969e+02 9.231124431282565013e+01 5.575513865545934067e+01 3.181994233636210723e+01 1.526605552196771676e+01
1.109903316849568711e+01 1.109903316849568711e+01 1.109903316849568711e+01 2.576633043611174045e+01 4.920320029178432719e+01 8.489667067689202895e+01 1.114666628562719239e+02 1.143498999771376390e+02 1.135327566935934556e+02 1.062785400205577133e+02 1.035552420320568672e+02 1.114666628562719239e+02 1.176666978393247263e+02 1.167015560382055526e+02 1.299493203489595317e+02 1.299493203489595317e+02 1.299493203489595317e+02 1.319159983451999665e+02 1.062785400205577133e+02 7.324025443754445064e+01 3.181994233636210723e+01 1.665967201206148474e+01
1.109903316849568711e+01 1.109903316849568711e+01 1.109903316849568711e+01 2.576633043611174045e+01 4.920320029178432719e+01 9.913832126014159485e+01 1.227650644017196271e+02 1.184030477988119969e+02 1.184030477988119969e+02 1.035552420320568672e+02 1.176666978393247263e+02 1.176666978393247263e+02 1.265982441579995168e+02 1.265982441579995168e+02 1.206223654132282377e+02 1.299493203489595317e+02 1.299493203489595317e+02 1.319159983451999665e+02 9.231124431282565013e+01 4.061688066462621549e+01 2.885164208177767264e+01 1.431094522473700081e+01
1.109903316849568711e+01 1.109903316849568711e+01 1.109903316849568711e+01 2.280717398950359609e+01 5.989400186644581936e+01 9.913832126014159485e+01 1.250020922091338065e+02 1.319159983451999665e+02 1.167015560382055526e+02 1.167015560382055526e+02 1.227650644017196271e+02 1.369383854450178148e+02 1.319159983451999665e+02 1.319159983451999665e+02 1.265982441579995168e+02 1.250020922091338065e+02 1.299493203489595317e+02 1.143498999771376390e+02 9.231124431282565013e+01 4.365723699118742474e+01 2.222875414701623242e+01 1.109903316849568711e+01
1.109903316849568711e+01 1.109903316849568711e+01 1.109903316849568711e+01 2.280717398950359609e+01 4.920320029178432719e+01 9.067636944300858204e+01 1.250020922091338065e+02 1.319159983451999665e+02 1.339719094069573941e+02 1.196588587051189734e+02 1.369383854450178148e+02 1.466920327395993127e+02 1.319159983451999665e+02 1.319159983451999665e+02 1.196588587051189734e+02 1.206223654132282377e+02 1.143498999771376390e+02 9.534515650147295673e+01 6.792067516693346363e+01 4.061688066462621549e+01 1.526605552196771676e+01 1.109903316849568711e+01
1.109903316849568711e+01 1.109903316849568711e+01 1.109903316849568711e+01 2.037717642487253045e+01 4.920320029178432719e+01 9.067636944300858204e+01 1.250020922091338065e+02 1.369383854450178148e+02 1.369383854450178148e+02 1.466920327395993127e+02 1.466920327395993127e+02 1.466920327395993127e+02 1.466920327395993127e+02 1.319159983451999665e+02 1.265982441579995168e+02 1.143498999771376390e+02 9.534515650147295673e+01 7.531464448858527305e+01 4.696457962548731757e+01 2.885164208177767264e+01 1.431094522473700081e+01 1.109903316849568711e+01
1.109903316849568711e+01 1.109903316849568711e+01 1.109903316849568711e+01 1.889280624234301342e+01 3.461725955835862578e+01 5.989400186644581936e+01 9.600845670949536270e+01 1.150273096482981856e+02 1.299493203489595317e+02 1.466920327395993127e+02 1.466920327395993127e+02 1.466920327395993127e+02 1.319159983451999665e+02 1.319159983451999665e+02 1.150273096482981856e+02 9.534515650147295673e+01 7.789184689230265235e+01 5.081419530259091033e+01 3.027412952338932683e+01 2.058666973254727850e+01 1.109903316849568711e+01 1.109903316849568711e+01
1.109903316849568711e+01 1.109903316849568711e+01 1.109903316849568711e+01 1.109903316849568711e+01 3.288001695737025898e+01 4.782193352476001991e+01 7.789184689230265235e+01 9.600845670949536270e+01 1.150273096482981856e+02 1.299493203489595317e+02 1.299493203489595317e+02 1.150273096482981856e+02 1.150273096482981856e+02 9.863130931790621503e+01 8.703056636145579716e+01 6.792067516693346363e+01 4.365723699118742474e+01 3.027412952338932683e+01 2.058666973254727850e+01 1.109903316849568711e+01 1.109903316849568711e+01 1.109903316849568711e+01
1.109903316849568711e+01 1.109903316849568711e+01 1.109903316849568711e+01 1.109903316849568711e+01 1.109903316849568711e+01 2.001272076723545723e+01 3.461725955835862578e+01 5.989400186644581936e+01 7.789184689230265235e+01 8.703056636145579716e+01 8.703056636145579716e+01 8.703056636145579716e+01 7.789184689230265235e+01 6.792067516693346363e+01 4.782193352476001991e+01 3.725047006992139131e+01 2.309656673970783913e+01 2.058666973254727850e+01 1.109903316849568711e+01 1.109903316849568711e+01 1.109903316849568711e+01 1.109903316849568711e+01
1.109903316849568711e+01 1.109903316849568711e+01 1.109903316849568711e+01 1.109903316849568711e+01 1.109903316849568711e+01 1.109903316849568711e+01 2.128248005830096545e+01 3.461725955835862578e+01 3.461725955835862578e+01 4.782193352476001991e+01 4.782193352476001991e+01 4.365723699118742474e+01 3.725047006992139131e+01 2.543293866501875655e+01 2.677174758537418242e+01 2.058666973254727850e+01 1.604969362477619654e+01 1.109903316849568711e+01 1.109903316849568711e+01 1.109903316849568711e+01 1.109903316849568711e+01 1.109903316849568711e+01
1.109903316849568711e+01 1.109903316849568711e+01 1.109903316849568711e+01 1.109903316849568711e+01 1.109903316849568711e+01 1.109903316849568711e+01 1.109903316849568711e+01 1.109903316849568711e+01 1.578386983041474068e+01 2.058666973254727850e+01 2.058666973254727850e+01 2.058666973254727850e+01 2.058666973254727850e+01 1.578386983041474068e+01 1.578386983041474068e+01 1.109903316849568711e+01 1.109903316849568711e+01 1.109903316849568711e+01 1.109903316849568711e+01 1.109903316849568711e+01 1.109903316849568711e+01 1.109903316849568711e+01
1.109903316849568711e+01 1.109903316849568711e+01 1.109903316849568711e+01 1.109903316849568711e+01 1.109903316849568711e+01 1.109903316849568711e+01 1.109903316849568711e+01 1.109903316849568711e+01 1.109903316849568711e+01 1.109903316849568711e+01 1.431094522473700081e+01 1.109903316849568711e+01 1.109903316849568711e+01 1.109903316849568711e+01 1.109903316849568711e+01 1.109903316849568711e+01 1.109903316849568711e+01 1.109903316849568711e+01 1.109903316849568711e+01 1.109903316849568711e+01 1.109903316849568711e+01 1.109903316849568711e+01
