1.050217629442819778e+01 1.050217629442819778e+01 1.050217629442819778e+01 1.050217629442819778e+01 1.050217629442819778e+01 1.050217629442819778e+01 1.050217629442819778e+01 1.050217629442819778e+01 1.050217629442819778e+01 1.050217629442819778e+01 1.050217629442819778e+01 1.050217629442819778e+01 1.050217629442819778e+01 1.050217629442819778e+01 1.050217629442819778e+01 1.050217629442819778e+01 1.745892276844493196e+01 2.402260654273660379e+01 3.016526386525699976e+01 3.670259630888821079e+01 2.446778686296064009e+01 2.013145738725555489e+01
1.050217629442819778e+01 1.050217629442819778e+01 1.050217629442819778e+01 1.050217629442819778e+01 1.050217629442819778e+01 1.050217629442819778e+01 1.050217629442819778e+01 1.050217629442819778e+01 1.050217629442819778e+01 1.050217629442819778e+01 1.050217629442819778e+01 1.050217629442819778e+01 1.050217629442819778e+01 1.050217629442819778e+01 1.050217629442819778e+01 1.050217629442819778e+01 2.240473426748988928e+01 4.546869228383084760e+01 5.567667964156981242e+01 5.484773131533903268e+01 3.918915021905391427e+01 1.906548892319178989e+01
1.050217629442819778e+01 1.050217629442819778e+01 1.050217629442819778e+01 1.050217629442819778e+01 1.050217629442819778e+01 1.050217629442819778e+01 1.050217629442819778e+01 1.862109329137441804e+01 2.020631289401081432e+01 1.902653654378126191e+01 1.902653654378126191e+01 1.050217629442819778e+01 1.050217629442819778e+01 1.050217629442819778e+01 1.050217629442819778e+01 2.043930303101348755e+01 3.931776404752616116e+01 6.135405439916909387e+01 7.863907114755616590e+01 6.850800299104827218e+01 4.117733576665477102e+01 1.906548892319178989e+01
1.050217629442819778e+01 1.050217629442819778e+01 1.050217629442819778e+01 1.050217629442819778e+01 1.050217629442819778e+01 1.050217629442819778e+01 1.991310736778258672e+01 2.654935526293989412e+01 3.639890175565260932e+01 3.670259630888821079e+01 2.446778686296064009e+01 1.906548892319178989e+01 1.050217629442819778e+01 1.050217629442819778e+01 1.745892276844493196e+01 3.078086852757643044e+01 5.411809171793269968e+01 7.675468885202526792e+01 8.123159619103329021e+01 6.624095697473059374e+01 3.682245226189340315e+01 1.906548892319178989e+01
1.050217629442819778e+01 1.050217629442819778e+01 1.050217629442819778e+01 1.050217629442819778e+01 1.050217629442819778e+01 1.050217629442819778e+01 2.710369719477488815e+01 4.442267694138367062e+01 5.493840559367321674e+01 5.484773131533903268e+01 3.554834218607269491e+01 2.225795739292221143e+01 1.050217629442819778e+01 1.050217629442819778e+01 2.240473426748988928e+01 4.570989842798477554e+01 6.745645962221630043e+01 8.629899109944625479e+01 8.031595472549491888e+01 5.600527556419728370e+01 3.057174326968897304e+01 1.986423608768883753e+01
1.050217629442819778e+01 1.050217629442819778e+01 1.050217629442819778e+01 1.050217629442819778e+01 1.050217629442819778e+01 2.153746841751789631e+01 3.931776404752616116e+01 6.135405439916909387e+01 7.863907114755616590e+01 6.850800299104827218e+01 4.656918998095571283e+01 2.225795739292221143e+01 1.405990782456909294e+01 1.745892276844493196e+01 2.930206855989474946e+01 5.578573843009480271e+01 7.675468885202526792e+01 8.342105042662657866e+01 6.466635262479873347e+01 4.212828744782621726e+01 2.272650440589485754e+01 1.050217629442819778e+01
1.050217629442819778e+01 1.050217629442819778e+01 1.050217629442819778e+01 1.050217629442819778e+01 2.043930303101348755e+01 3.512900503919944839e+01 6.057974912402647050e+01 7.810901609164456261e+01 8.123159619103329021e+01 6.624095697473059374e+01 4.022532353939172367e+01 2.376997270242555516e+01 1.476743268245147789e+01 2.043930303101348755e+01 3.874546525113728990e+01 6.745645962221630043e+01 7.936812083099587767e+01 8.031595472549491888e+01 5.600527556419728370e+01 3.057174326968897304e+01 1.986423608768883753e+01 1.050217629442819778e+01
1.050217629442819778e+01 1.050217629442819778e+01 1.050217629442819778e+01 1.991310736778258672e+01 3.146253022621258211e+01 5.323397792476212942e+01 7.675468885202526792e+01 8.629899109944625479e+01 7.761527331379596717e+01 5.238529566916119506e+01 3.057174326968897304e+01 1.470065605582684753e+01 1.932788566997604462e+01 3.078086852757643044e+01 5.679270779981640516e+01 7.675468885202526792e+01 8.342105042662657866e+01 6.887574347237976724e+01 4.212828744782621726e+01 2.376997270242555516e+01 1.050217629442819778e+01 1.050217629442819778e+01
1.050217629442819778e+01 1.050217629442819778e+01 1.050217629442819778e+01 2.240473426748988928e+01 4.570989842798477554e+01 6.354814291938082960e+01 7.936812083099587767e+01 8.277660847023111046e+01 6.219682645878923211e+01 3.861882199603168431e+01 2.272650440589485754e+01 1.476743268245147789e+01 2.240473426748988928e+01 4.570989842798477554e+01 7.350414531752647918e+01 7.936812083099587767e+01 8.031595472549491888e+01 5.238529566916119506e+01 3.057174326968897304e+01 1.986423608768883753e+01 1.050217629442819778e+01 1.050217629442819778e+01
1.050217629442819778e+01 1.050217629442819778e+01 2.043930303101348755e+01 3.729886400005740654e+01 6.249927297860704556e+01 8.245860574592829551e+01 8.629899109944625479e+01 7.482269120075137891e+01 4.337609904439219832e+01 2.706596773584728055e+01 2.009624735257509798e+01 2.205342545170306323e+01 3.512900503919944839e+01 6.249927297860704556e+01 8.508801691092897101e+01 8.629899109944625479e+01 7.049869490066110700e+01 4.369778929315922511e+01 2.376997270242555516e+01 1.050217629442819778e+01 1.050217629442819778e+01 1.050217629442819778e+01
1.050217629442819778e+01 1.050217629442819778e+01 2.533488636311268394e+01 4.944524398532483644e+01 7.674615832648240143e+01 1.002646266512682018e+02 9.304362957474532436e+01 6.807335879705760817e+01 5.003804868758724211e+01 3.251613285207153581e+01 3.309754005061930826e+01 3.655918591624698166e+01 5.417285374839192968e+01 8.254611543872860580e+01 9.537868061403233355e+01 9.304362957474532436e+01 6.616659472262693953e+01 3.447532975372389785e+01 1.906548892319178989e+01 1.050217629442819778e+01 1.050217629442819778e+01 1.050217629442819778e+01
1.050217629442819778e+01 1.932788566997604462e+01 3.047931416392753334e+01 6.617916046282134346e+01 9.242069633905123283e+01 1.160525952203547320e+02 1.036852819067594993e+02 8.138320786961023146e+01 6.599968489750945366e+01 6.494979191811491148e+01 6.494979191811491148e+01 6.944894883599411628e+01 8.398778897932785981e+01 1.049830909934484140e+02 1.131951901395395907e+02 9.535180925751495806e+01 6.616659472262693953e+01 3.397802769945866430e+01 1.935590519696998868e+01 1.050217629442819778e+01 1.050217629442819778e+01 1.050217629442819778e+01
1.050217629442819778e+01 2.015026756361512739e+01 3.684407484630823859e+01 6.896629038657412991e+01 1.005806623717835606e+02 1.193991672096728678e+02 1.101107541278961151e+02 1.116173084948184453e+02 9.313162536897820587e+01 9.518514731297031517e+01 9.586122096599405040e+01 1.015770367540467447e+02 1.117527680697920260e+02 1.131951901395395907e+02 1.101816711259983919e+02 8.698207644204552480e+01 5.815368413564549854e+01 3.000317699048927977e+01 1.470065605582684753e+01 1.050217629442819778e+01 1.050217629442819778e+01 1.050217629442819778e+01
1.050217629442819778e+01 2.015026756361512739e+01 3.218521842226653717e+01 6.528522965349816332e+01 9.921281662072594543e+01 1.157072300421681490e+02 1.222726101420641243e+02 1.176064711653974229e+02 1.129639552438773791e+02 1.192156198305081034e+02 1.192156198305081034e+02 1.212482890601196317e+02 1.260716253801291344e+02 1.124732570086954553e+02 9.868036232457166079e+01 6.876660872789557288e+01 4.517490336729686362e+01 2.554709563449646481e+01 1.050217629442819778e+01 1.050217629442819778e+01 1.050217629442819778e+01 1.050217629442819778e+01
1.050217629442819778e+01 1.745892276844493196e+01 2.765107264361366290e+01 4.996477788781766094e+01 6.520853516644879733e+01 9.133264399004667666e+01 9.502585619177121146e+01 9.566195719471930659e+01 9.502585619177121146e+01 1.021062822974206910e+02 1.157072300421681490e+02 1.248469366865387542e+02 1.246182494969465893e+02 9.868036232457166079e+01 7.678200225196205508e+01 4.675481816919838707e+01 2.925070662846538028e+01 2.131223752851666120e+01 1.050217629442819778e+01 1.050217629442819778e+01 1.050217629442819778e+01 1.050217629442819778e+01
1.050217629442819778e+01 1.050217629442819778e+01 2.115019314448392507e+01 2.901029638712745751e+01 4.554449607151907031e+01 5.297175540365222446e+01 6.227334339045947331e+01 6.227334339045947331e+01 7.204235844989709392e+01 7.818406345734186402e+01 9.921281662072594543e+01 1.056331118742211004e+02 1.061224476820396490e+02 7.717781068450918269e+01 4.675481816919838707e+01 2.613463092226445994e+01 2.059686595830186917e+01 1.050217629442819778e+01 1.050217629442819778e+01 1.050217629442819778e+01 1.050217629442819778e+01 1.050217629442819778e+01
1.050217629442819778e+01 1.050217629442819778e+01 1.050217629442819778e+01 2.115019314448392507e+01 2.021653688714377139e+01 2.607248687012923938e+01 2.863306196066779208e+01 3.678747120766308143e+01 3.766288281097942559e+01 6.853129718895958433e+01 9.103569175305571548e+01 9.829415097172382332e+01 8.698207644204552480e+01 5.600527556419728370e+01 3.057174326968897304e+01 1.986423608768883753e+01 1.050217629442819778e+01 1.050217629442819778e+01 1.050217629442819778e+01 1.050217629442819778e+01 1.050217629442819778e+01 1.050217629442819778e+01
1.050217629442819778e+01 1.050217629442819778e+01 1.050217629442819778e+01 1.050217629442819778e+01 1.050217629442819778e+01 1.050217629442819778e+01 1.580726831739931626e+01 2.519355598115564376e+01 3.785191008777426447e+01 6.561913886213963565e+01 9.149135301746912319e+01 9.229863728258497702e+01 6.996169846766517253e+01 4.212828744782621726e+01 2.131223752851666120e+01 1.050217629442819778e+01 1.050217629442819778e+01 1.050217629442819778e+01 1.050217629442819778e+01 1.050217629442819778e+01 1.050217629442819778e+01 1.050217629442819778e+01
1.050217629442819778e+01 1.050217629442819778e+01 1.050217629442819778e+01 1.050217629442819778e+01 1.050217629442819778e+01 1.050217629442819778e+01 1.050217629442819778e+01 2.015026756361512739e+01 4.563872838609567140e+01 7.469672483632444937e+01 9.264618921930600948e+01 8.082945681250760117e+01 5.600527556419728370e+01 3.057174326968897304e+01 1.986423608768883753e+01 1.050217629442819778e+01 1.050217629442819778e+01 1.050217629442819778e+01 1.050217629442819778e+01 1.050217629442819778e+01 1.050217629442819778e+01 1.050217629442819778e+01
1.050217629442819778e+01 1.050217629442819778e+01 1.050217629442819778e+01 1.050217629442819778e+01 1.050217629442819778e+01 1.050217629442819778e+01 1.050217629442819778e+01 2.015026756361512739e+01 4.147295039906052239e+01 6.667787997409557477e+01 8.487341781897679027e+01 6.466635262479873347e+01 3.861882199603168431e+01 2.131223752851666120e+01 1.050217629442819778e+01 1.050217629442819778e+01 1.050217629442819778e+01 1.050217629442819778e+01 1.050217629442819778e+01 1.050217629442819778e+01 1.050217629442819778e+01 1.050217629442819778e+01
1.050217629442819778e+01 1.050217629442819778e+01 1.050217629442819778e+01 1.050217629442819778e+01 1.050217629442819778e+01 1.050217629442819778e+01 1.050217629442819778e+01 2.435920895946700071e+01 3.790172973766873810e+01 5.243501032617260194e+01 5.530747119206352380e+01 4.527825277422861916e+01 2.554709563449646481e+01 1.050217629442819778e+01 1.050217629442819778e+01 1.050217629442819778e+01 1.050217629442819778e+01 1.050217629442819778e+01 1.050217629442819778e+01 1.050217629442819778e+01 1.050217629442819778e+01 1.050217629442819778e+01
1.050217629442819778e+01 1.050217629442819778e+01 1.050217629442819778e+01 1.050217629442819778e+01 1.050217629442819778e+01 1.050217629442819778e+01 1.050217629442819778e+01 2.115019314448392507e+01 2.323018878019807687e+01 3.466447217527978353e+01 3.143125894785098140e+01 2.272650440589485754e+01 1.986423608768883753e+01 1.050217629442819778e+01 1.050217629442819778e+01 1.050217629442819778e+01 1.050217629442819778e+01 1.050217629442819778e+01 1.050217629442819778e+01 1.050217629442819778e+01 1.050217629442819778e+01 1.050217629442819778e+01
