1.349986171256351009e+00 1.349986171256351009e+00 1.349986171256351009e+00 1.349986171256351009e+00 1.349986171256351009e+00 5.072189153439152776e-01 9.071791495912098213e-01 9.246575543797767027e-01 1.009623094175419622e+00 1.342696858857270303e+00 1.037620383731494789e+00 1.094513261071400567e+00 1.342696858857270303e+00 1.394860076800541027e+00 1.546601488402492786e+00 1.401280161806324642e+00 1.212679398148148069e+00 9.542336628736156623e-01 7.025718694885362270e-01 4.497633744855966675e-01 4.497633744855966675e-01 5.072189153439152776e-01
1.349986171256351009e+00 1.349986171256351009e+00 1.349986171256351009e+00 1.349986171256351009e+00 5.072189153439152776e-01 4.497633744855966675e-01 7.808065633660872251e+00 1.194479276895943354e+00 5.554239303643735326e+01 8.577897949380196962e+01 5.554239303643735326e+01 1.458062364035809537e+02 5.554239303643735326e+01 8.388047959735146719e+01 3.423528778350195978e+01 1.477375116086301343e+00 1.198074345750271830e+00 4.497633744855966675e-01 5.072189153439152776e-01 4.497633744855966675e-01 4.497633744855966675e-01 5.072189153439152776e-01
1.349986171256351009e+00 1.349986171256351009e+00 1.349986171256351009e+00 1.349986171256351009e+00 4.497633744855966675e-01 5.072189153439152776e-01 1.036437669782039883e+00 1.297191209066208994e+00 7.537297677722457934e+01 1.233197696687370666e+02 1.240423044432419317e+02 1.557078093751281642e+02 1.458062364035809537e+02 1.458062364035809537e+02 1.605881669330980799e+02 6.706471388902102149e+01 1.628791121052313606e+00 9.935548053633974641e-01 9.071791495912098213e-01 4.497633744855966675e-01 4.497633744855966675e-01 5.072189153439152776e-01
1.349986171256351009e+00 1.349986171256351009e+00 1.349986171256351009e+00 1.349986171256351009e+00 4.497633744855966675e-01 1.036437669782039883e+00 1.832741781761381139e+00 1.593848482766635044e+00 3.010413418577308065e+01 3.738523143555261896e+01 3.937030621693121191e+01 3.306619311317624010e+01 1.496892906701939978e+02 1.522604110082304487e+02 1.627658070816071927e+02 1.115132138111732871e+02 1.531800555023214772e+00 1.401280161806324642e+00 1.171223513775203173e+00 4.497633744855966675e-01 4.497633744855966675e-01 5.072189153439152776e-01
1.349986171256351009e+00 1.349986171256351009e+00 1.349986171256351009e+00 1.349986171256351009e+00 5.072189153439152776e-01 5.072189153439152776e-01 1.617992501898121827e+00 1.635438938740562120e+00 1.171223513775203173e+00 5.072189153439152776e-01 1.706502314814814625e+01 1.212679398148148069e+00 7.537297677722457934e+01 1.343465484917795720e+02 1.664320139789601285e+02 1.639431952440216946e+02 3.708870565521303675e+00 1.546601488402492786e+00 2.439104938271604794e+00 1.297191209066208994e+00 4.497633744855966675e-01 4.497633744855966675e-01
1.349986171256351009e+00 1.349986171256351009e+00 1.349986171256351009e+00 1.349986171256351009e+00 4.497633744855966675e-01 5.072189153439152776e-01 7.025718694885362270e-01 1.212679398148148069e+00 1.212679398148148069e+00 7.025718694885362270e-01 5.072189153439152776e-01 1.673766974229390136e+00 2.806668582945412105e+00 1.598761989109020476e+02 1.656301083843969195e+02 1.664173967661327254e+02 2.506431474593490094e+01 2.383713073192240017e+00 1.212679398148148069e+00 7.025718694885362270e-01 7.025718694885362270e-01 5.072189153439152776e-01
1.349986171256351009e+00 1.349986171256351009e+00 1.349986171256351009e+00 1.349986171256351009e+00 4.497633744855966675e-01 4.497633744855966675e-01 9.348875041229920413e-01 1.212679398148148069e+00 9.369671274679511885e-01 4.497633744855966675e-01 9.071791495912098213e-01 9.369671274679511885e-01 1.147343450296616822e+02 1.656301083843969195e+02 1.656282569193701590e+02 6.656295775739383203e+01 4.497633744855966675e-01 5.072189153439152776e-01 1.212679398148148069e+00 9.071791495912098213e-01 4.497633744855966675e-01 5.072189153439152776e-01
1.349986171256351009e+00 1.349986171256351009e+00 1.349986171256351009e+00 1.349986171256351009e+00 5.072189153439152776e-01 4.497633744855966675e-01 9.838274337348410503e-01 9.838274337348410503e-01 9.369671274679511885e-01 9.369671274679511885e-01 1.037620383731494789e+00 4.283696269351256092e+01 1.295388264172239303e+02 1.226430348131130046e+02 1.664173967661327254e+02 1.765377853839893207e+00 9.935548053633974641e-01 9.542336628736156623e-01 9.071791495912098213e-01 1.119177216167768441e+00 7.025718694885362270e-01 4.497633744855966675e-01
1.349986171256351009e+00 1.349986171256351009e+00 1.349986171256351009e+00 1.349986171256351009e+00 1.349986171256351009e+00 4.497633744855966675e-01 4.497633744855966675e-01 9.838274337348410503e-01 1.034546938447011621e+00 1.297191209066208994e+00 3.392187769208634762e+01 1.080600193413492178e+02 1.462634030869999151e+02 9.830381640443701485e+01 1.493365465960169391e+00 1.212679398148148069e+00 5.072189153439152776e-01 7.025718694885362270e-01 9.071791495912098213e-01 1.072453979276895675e+00 9.369671274679511885e-01 5.072189153439152776e-01
1.349986171256351009e+00 1.349986171256351009e+00 1.349986171256351009e+00 1.349986171256351009e+00 1.349986171256351009e+00 5.072189153439152776e-01 4.497633744855966675e-01 1.212679398148148069e+00 9.071791495912098213e-01 1.509772506682844195e+01 8.885150363574712173e+01 1.424960513888889011e+02 1.285142045978697638e+02 1.617992501898121827e+00 1.212679398148148069e+00 1.171223513775203173e+00 1.034546938447011621e+00 9.369671274679511885e-01 9.838274337348410503e-01 1.009623094175419622e+00 4.497633744855966675e-01 5.072189153439152776e-01
1.349986171256351009e+00 1.349986171256351009e+00 1.349986171256351009e+00 1.349986171256351009e+00 1.349986171256351009e+00 4.497633744855966675e-01 1.401280161806324642e+00 1.212679398148148069e+00 1.036331356096759526e+00 4.283696269351256092e+01 1.080600193413492178e+02 1.639431952440216946e+02 1.192759113749097821e+02 1.396955483262673381e+00 1.342696858857270303e+00 9.369671274679511885e-01 9.369671274679511885e-01 4.497633744855966675e-01 4.497633744855966675e-01 5.072189153439152776e-01 4.497633744855966675e-01 4.497633744855966675e-01
1.349986171256351009e+00 1.349986171256351009e+00 1.349986171256351009e+00 1.349986171256351009e+00 5.072189153439152776e-01 1.212679398148148069e+00 1.342696858857270303e+00 1.394860076800541027e+00 1.087710189287132145e+01 1.147343450296616822e+02 1.478958267717891317e+02 6.271313725789642035e+01 1.957776864088232482e+00 1.531800555023214772e+00 7.025718694885362270e-01 5.072189153439152776e-01 5.072189153439152776e-01 4.497633744855966675e-01 4.497633744855966675e-01 4.497633744855966675e-01 5.072189153439152776e-01 5.072189153439152776e-01
5.072189153439152776e-01 1.349986171256351009e+00 1.349986171256351009e+00 1.349986171256351009e+00 4.497633744855966675e-01 5.072189153439152776e-01 1.283958385341307906e+00 3.392187769208634762e+01 1.147343450296616822e+02 1.259919907807245352e+02 6.131871453079215684e+01 1.803511643946359211e+00 1.421058955315390504e+00 9.935548053633974641e-01 4.497633744855966675e-01 7.025718694885362270e-01 5.072189153439152776e-01 9.071791495912098213e-01 9.935548053633974641e-01 1.297191209066208994e+00 4.497633744855966675e-01 4.497633744855966675e-01
5.072189153439152776e-01 5.072189153439152776e-01 5.072189153439152776e-01 4.497633744855966675e-01 4.497633744855966675e-01 9.071791495912098213e-01 9.369671274679511885e-01 1.195025193486234940e+02 1.664820817277029619e+02 9.830381640443701485e+01 1.617992501898121827e+00 1.401280161806324642e+00 1.212679398148148069e+00 1.171223513775203173e+00 9.246575543797767027e-01 9.071791495912098213e-01 9.935548053633974641e-01 1.212679398148148069e+00 1.493365465960169391e+00 1.212679398148148069e+00 7.025718694885362270e-01 5.072189153439152776e-01
4.497633744855966675e-01 5.072189153439152776e-01 9.935548053633974641e-01 1.283476738375510795e+00 1.212679398148148069e+00 1.036331356096759526e+00 4.283696269351256092e+01 1.443520241069347492e+02 1.646829350872040436e+02 7.439496561218672355e+01 2.319380089301797288e+00 1.342696858857270303e+00 1.009623094175419622e+00 1.274675296978651007e+00 9.369671274679511885e-01 2.038790367525499025e+00 1.593848482766635044e+00 1.617992501898121827e+00 1.253454120480974820e+00 1.581725009827453787e+00 5.072189153439152776e-01 5.072189153439152776e-01
4.497633744855966675e-01 5.072189153439152776e-01 1.212679398148148069e+00 1.198074345750271830e+00 2.859328994308161143e+01 4.283696269351256092e+01 1.651181394903353521e+02 1.664820817277029619e+02 9.402191351942555286e+01 2.319380089301797288e+00 2.038790367525499025e+00 1.957776864088232482e+00 1.477375116086301343e+00 1.481574737733978520e+00 1.297191209066208994e+00 1.372165173707753594e+00 1.477153684107387566e+00 2.346949951622896435e+01 1.394860076800541027e+00 9.935548053633974641e-01 4.497633744855966675e-01 4.497633744855966675e-01
1.297191209066208994e+00 1.171223513775203173e+00 1.040010443945629026e+00 1.283958385341307906e+00 5.554239303643735326e+01 1.664320139789601285e+02 1.665733579608744037e+02 1.656282569193701590e+02 1.653663665305725505e+00 1.694052209162490996e+00 1.997328622435447842e+00 1.546601488402492786e+00 1.342696858857270303e+00 1.342696858857270303e+00 1.394860076800541027e+00 3.276175566554354646e+01 5.857234960394077916e+01 1.546601488402492786e+00 1.628791121052313606e+00 1.493365465960169391e+00 1.171223513775203173e+00 5.072189153439152776e-01
1.401280161806324642e+00 1.171223513775203173e+00 1.071660523593004122e+00 4.341516556437389340e+01 1.409374721155610928e+02 1.667083138957390531e+02 1.667905184258190445e+02 1.664173967661327254e+02 9.930795990867586909e+01 2.853258733389124302e+01 1.867992560852577810e+01 5.857234960394077916e+01 6.725149032956804263e+01 5.554239303643735326e+01 5.554239303643735326e+01 1.364624764802322829e+02 1.233197696687370666e+02 4.681086948237775403e+01 1.803511643946359211e+00 1.396955483262673381e+00 1.171223513775203173e+00 5.072189153439152776e-01
1.264293660930103869e+00 1.171223513775203173e+00 9.369671274679511885e-01 5.072189153439152776e-01 1.354666439559426294e+02 1.557078093751281642e+02 1.656282569193701590e+02 1.656282569193701590e+02 1.325497702689509367e+02 5.554239303643735326e+01 1.072142475092050944e+02 1.385961108587440833e+02 1.443520241069347492e+02 1.478958267717891317e+02 9.830381640443701485e+01 6.160179966452889033e+01 3.306619311317624010e+01 1.617992501898121827e+00 1.333656663109014096e+00 1.431829875630662441e+00 9.369671274679511885e-01 4.497633744855966675e-01
1.394860076800541027e+00 1.394860076800541027e+00 9.369671274679511885e-01 5.072189153439152776e-01 5.072189153439152776e-01 5.072189153439152776e-01 8.432515455170009488e+01 3.635059288954232670e+01 3.306619311317624010e+01 3.738523143555261896e+01 3.606903213655833440e+01 7.537297677722457934e+01 1.656282569193701590e+02 5.007785094285969052e+01 5.786065985081314977e+01 1.212679398148148069e+00 5.072189153439152776e-01 1.033120940420809708e+00 5.072189153439152776e-01 1.394860076800541027e+00 5.072189153439152776e-01 4.497633744855966675e-01
1.009623094175419622e+00 4.497633744855966675e-01 4.497633744855966675e-01 4.497633744855966675e-01 4.497633744855966675e-01 5.072189153439152776e-01 1.706502314814814625e+01 5.072189153439152776e-01 1.033120940420809708e+00 1.033120940420809708e+00 5.072189153439152776e-01 5.072189153439152776e-01 1.333656663109014096e+00 5.072189153439152776e-01 1.100056925644604444e+00 1.706502314814814625e+01 4.497633744855966675e-01 4.497633744855966675e-01 4.497633744855966675e-01 4.497633744855966675e-01 5.072189153439152776e-01 1.349986171256351009e+00
1.349986171256351009e+00 1.349986171256351009e+00 1.349986171256351009e+00 1.349986171256351009e+00 1.349986171256351009e+00 5.072189153439152776e-01 4.497633744855966675e-01 4.497633744855966675e-01 4.497633744855966675e-01 4.497633744855966675e-01 4.497633744855966675e-01 5.072189153439152776e-01 4.497633744855966675e-01 5.072189153439152776e-01 4.497633744855966675e-01 5.072189153439152776e-01 1.349986171256351009e+00 1.349986171256351009e+00 1.349986171256351009e+00 1.349986171256351009e+00 1.349986171256351009e+00 1.349986171256351009e+00
