1.049044217551618630e+01 1.049044217551618630e+01 1.049044217551618630e+01 1.049044217551618630e+01 1.049044217551618630e+01 1.049044217551618630e+01 2.043930303101348755e+01 3.232573919319023759e+01 4.812483281848884076e+01 6.449574610260309271e+01 7.507074258425417668e+01 8.448826993091900306e+01 7.882506888120558131e+01 7.542310173340568724e+01 5.159184330117459893e+01 3.180698256657733225e+01 2.013145738725555489e+01 1.049044217551618630e+01 1.049044217551618630e+01 1.049044217551618630e+01 1.049044217551618630e+01 1.049044217551618630e+01
1.049044217551618630e+01 1.049044217551618630e+01 1.049044217551618630e+01 1.049044217551618630e+01 1.049044217551618630e+01 1.049044217551618630e+01 2.487014464207499742e+01 4.670315461909069654e+01 6.663619671759731489e+01 9.154515847884198365e+01 9.756667169143356944e+01 1.035586477473341205e+02 1.024932893535961256e+02 9.570091673028910861e+01 8.138320786961023146e+01 5.936752361456566973e+01 3.025936968457882159e+01 1.900148897231607492e+01 1.049044217551618630e+01 1.049044217551618630e+01 1.049044217551618630e+01 1.049044217551618630e+01
1.049044217551618630e+01 1.049044217551618630e+01 1.049044217551618630e+01 1.049044217551618630e+01 1.049044217551618630e+01 1.745953431496455721e+01 2.964090235024836417e+01 5.156060696554258982e+01 6.751873193093665293e+01 8.869976217904030591e+01 8.487341781897679027e+01 9.502585619177121146e+01 9.021945326150768096e+01 1.048284766505503711e+02 1.007337887580142421e+02 7.634979047202295988e+01 4.588841205490970765e+01 2.394983016203091353e+01 1.049044217551618630e+01 1.049044217551618630e+01 1.049044217551618630e+01 1.049044217551618630e+01
1.049044217551618630e+01 1.049044217551618630e+01 1.049044217551618630e+01 1.049044217551618630e+01 1.049044217551618630e+01 1.745953431496455721e+01 2.765107264361366290e+01 4.850517644856327593e+01 6.175476398070640727e+01 6.598004956872136972e+01 6.547501984676775066e+01 6.815687936568926375e+01 7.818406345734186402e+01 8.867818257388033487e+01 1.048284766505503711e+02 9.013486743869660245e+01 5.936752361456566973e+01 3.554834218607269491e+01 1.906548892319178989e+01 1.049044217551618630e+01 1.049044217551618630e+01 1.049044217551618630e+01
1.049044217551618630e+01 1.049044217551618630e+01 1.049044217551618630e+01 1.049044217551618630e+01 1.049044217551618630e+01 1.049044217551618630e+01 2.440327033244665955e+01 3.466447217527978353e+01 3.867588332652246663e+01 3.867588332652246663e+01 3.424084975776487028e+01 3.678747120766308143e+01 5.745317212735775314e+01 6.914307303127056059e+01 9.344078755717345075e+01 9.933255665655939026e+01 7.342590993661410437e+01 4.446664353507483014e+01 1.906548892319178989e+01 1.049044217551618630e+01 1.049044217551618630e+01 1.049044217551618630e+01
1.049044217551618630e+01 1.049044217551618630e+01 1.049044217551618630e+01 1.049044217551618630e+01 1.049044217551618630e+01 1.049044217551618630e+01 1.049044217551618630e+01 2.021653688714377139e+01 2.021653688714377139e+01 2.079276208285052263e+01 1.581130115740249842e+01 2.105103243576855121e+01 3.833852913627998760e+01 6.511497281623604749e+01 9.602994678875198531e+01 9.924698512481182888e+01 7.190907132311065197e+01 4.628944932260192502e+01 1.906548892319178989e+01 1.049044217551618630e+01 1.049044217551618630e+01 1.049044217551618630e+01
1.049044217551618630e+01 1.049044217551618630e+01 1.049044217551618630e+01 1.049044217551618630e+01 1.049044217551618630e+01 1.049044217551618630e+01 1.049044217551618630e+01 1.049044217551618630e+01 1.581130115740249842e+01 1.641906523618316527e+01 2.020631289401081432e+01 2.343949468436466788e+01 4.059434362976279687e+01 6.980948091781502285e+01 9.203955440175553804e+01 9.590318304277255379e+01 6.882399794553158756e+01 4.116663486185557730e+01 1.906548892319178989e+01 1.049044217551618630e+01 1.049044217551618630e+01 1.049044217551618630e+01
1.049044217551618630e+01 1.049044217551618630e+01 1.049044217551618630e+01 1.049044217551618630e+01 1.049044217551618630e+01 1.049044217551618630e+01 1.049044217551618630e+01 1.049044217551618630e+01 1.861619606653899694e+01 2.153746841751789631e+01 3.604258471189580604e+01 4.756463616943907624e+01 6.449574610260309271e+01 8.454092692081326277e+01 9.630142159811965996e+01 8.788248763071776182e+01 5.815368413564549854e+01 3.239101134701016349e+01 1.986423608768883753e+01 1.049044217551618630e+01 1.049044217551618630e+01 1.049044217551618630e+01
1.049044217551618630e+01 1.049044217551618630e+01 1.049044217551618630e+01 1.049044217551618630e+01 1.049044217551618630e+01 1.049044217551618630e+01 1.049044217551618630e+01 1.049044217551618630e+01 2.043930303101348755e+01 3.729886400005740654e+01 5.920202410051773256e+01 8.017638456827901905e+01 9.537845212338746137e+01 1.046550669442669488e+02 9.710041259476005848e+01 7.485090876127452475e+01 4.864330109183711670e+01 2.554709563449646481e+01 1.049044217551618630e+01 1.049044217551618630e+01 1.049044217551618630e+01 1.049044217551618630e+01
1.049044217551618630e+01 1.049044217551618630e+01 1.049044217551618630e+01 1.049044217551618630e+01 1.049044217551618630e+01 1.049044217551618630e+01 1.049044217551618630e+01 1.049044217551618630e+01 2.015026756361512739e+01 4.699552093916560835e+01 6.903203303620415454e+01 9.639202930946946424e+01 1.118286310094269425e+02 1.215714002521811636e+02 9.953039972471475494e+01 7.102694237665778587e+01 4.022933901214336316e+01 1.986423608768883753e+01 1.049044217551618630e+01 1.049044217551618630e+01 1.049044217551618630e+01 1.049044217551618630e+01
1.049044217551618630e+01 1.049044217551618630e+01 1.049044217551618630e+01 1.049044217551618630e+01 1.049044217551618630e+01 1.049044217551618630e+01 1.049044217551618630e+01 1.049044217551618630e+01 2.435920895946700071e+01 4.692982431347663663e+01 6.667787997409557477e+01 1.026459358858047040e+02 1.231107620999831056e+02 1.222726101420641243e+02 1.022215173366967349e+02 7.324171881884836921e+01 3.509631159257600075e+01 1.906548892319178989e+01 1.049044217551618630e+01 1.049044217551618630e+01 1.049044217551618630e+01 1.049044217551618630e+01
1.049044217551618630e+01 1.049044217551618630e+01 1.049044217551618630e+01 1.049044217551618630e+01 1.049044217551618630e+01 1.049044217551618630e+01 1.049044217551618630e+01 1.049044217551618630e+01 2.115673337070694515e+01 2.926272101418998517e+01 4.996477788781766094e+01 8.071193698427848062e+01 1.026459358858047040e+02 1.109871827410836858e+02 1.101107541278961151e+02 7.839936863692764746e+01 4.437858404374203047e+01 2.318502891486033590e+01 1.049044217551618630e+01 1.049044217551618630e+01 1.049044217551618630e+01 1.049044217551618630e+01
1.049044217551618630e+01 1.049044217551618630e+01 1.049044217551618630e+01 1.049044217551618630e+01 1.049044217551618630e+01 1.049044217551618630e+01 1.049044217551618630e+01 1.476668957763119927e+01 1.745953431496455721e+01 2.251661649761027562e+01 3.541591558233890424e+01 5.961319197637604361e+01 8.071193698427848062e+01 9.986594272496968472e+01 1.024932893535961256e+02 8.241584257593706297e+01 5.487552181678658769e+01 2.567015351301001758e+01 1.049044217551618630e+01 1.049044217551618630e+01 1.049044217551618630e+01 1.049044217551618630e+01
1.049044217551618630e+01 1.049044217551618630e+01 1.049044217551618630e+01 1.049044217551618630e+01 1.049044217551618630e+01 1.049044217551618630e+01 1.991310736778258672e+01 2.033813614312694185e+01 2.842362861704922850e+01 2.725551120956087559e+01 2.876580400081774513e+01 3.541591558233890424e+01 6.307626278538046449e+01 8.844806095342228502e+01 1.102358725322514488e+02 9.535180925751495806e+01 6.421218164412613305e+01 3.011660708635344719e+01 1.049044217551618630e+01 1.049044217551618630e+01 1.049044217551618630e+01 1.049044217551618630e+01
1.049044217551618630e+01 1.049044217551618630e+01 1.049044217551618630e+01 1.049044217551618630e+01 1.049044217551618630e+01 2.153746841751789631e+01 3.394244874779461441e+01 4.470904285191778627e+01 5.151991013666993524e+01 5.076498001881681432e+01 4.298453589303452560e+01 4.139904611284603675e+01 5.345874823565608835e+01 7.686980701091836465e+01 1.066115218314864705e+02 9.933255665655939026e+01 6.616659472262693953e+01 3.447532975372389785e+01 1.935590519696998868e+01 1.049044217551618630e+01 1.049044217551618630e+01 1.049044217551618630e+01
1.049044217551618630e+01 1.049044217551618630e+01 1.049044217551618630e+01 1.049044217551618630e+01 2.153746841751789631e+01 3.512900503919944839e+01 5.417285374839192968e+01 8.017638456827901905e+01 8.054193878593450506e+01 7.437357104700166133e+01 6.022504846039430504e+01 4.987636491354626145e+01 6.354814291938082960e+01 8.541677515121669728e+01 9.941135384387433760e+01 9.224023257253776364e+01 6.222461195211505469e+01 3.372182633043891542e+01 1.935590519696998868e+01 1.049044217551618630e+01 1.049044217551618630e+01 1.049044217551618630e+01
1.049044217551618630e+01 1.049044217551618630e+01 1.049044217551618630e+01 1.991310736778258672e+01 3.146671015123245496e+01 6.057974912402647050e+01 8.422874325894495939e+01 1.088570908412267073e+02 1.136886036706708012e+02 1.007337887580142421e+02 9.118238354928705292e+01 7.882506888120558131e+01 8.054193878593450506e+01 9.341640621041497639e+01 9.765868052318273840e+01 8.081736219213949823e+01 5.064403422730880777e+01 2.554709563449646481e+01 1.049044217551618630e+01 1.049044217551618630e+01 1.049044217551618630e+01 1.049044217551618630e+01
1.049044217551618630e+01 1.049044217551618630e+01 1.049044217551618630e+01 2.319158860727053195e+01 4.793588098912375273e+01 7.790386979332021156e+01 1.113627249291354815e+02 1.245774883317600796e+02 1.281877121070124304e+02 1.240415228443710305e+02 1.071515851078959543e+02 9.672085249771242843e+01 9.486439494644091042e+01 9.691663411813181028e+01 8.878914915516438100e+01 6.219682645878923211e+01 4.212828744782621726e+01 2.265888902225694324e+01 1.049044217551618630e+01 1.049044217551618630e+01 1.049044217551618630e+01 1.049044217551618630e+01
1.049044217551618630e+01 1.049044217551618630e+01 1.049044217551618630e+01 2.435920895946700071e+01 4.735107366498647963e+01 7.548157082825299824e+01 1.145710934497178926e+02 1.228015672572324206e+02 1.217130681857276073e+02 1.217130681857276073e+02 1.078002916555558102e+02 1.093102638116723710e+02 9.583069483576340986e+01 8.386479610967056431e+01 6.090546621375322900e+01 4.527825277422861916e+01 2.554709563449646481e+01 1.581130115740249842e+01 1.049044217551618630e+01 1.049044217551618630e+01 1.049044217551618630e+01 1.049044217551618630e+01
1.049044217551618630e+01 1.049044217551618630e+01 1.049044217551618630e+01 2.280717398950359609e+01 4.692982431347663663e+01 6.535314451345057307e+01 7.706757663340836473e+01 9.502585619177121146e+01 9.502585619177121146e+01 9.502585619177121146e+01 7.967645822030814884e+01 8.250853467910826566e+01 6.802219923331432483e+01 5.665476014420391238e+01 3.789068517900032873e+01 2.665700094415997867e+01 1.581130115740249842e+01 1.049044217551618630e+01 1.049044217551618630e+01 1.049044217551618630e+01 1.049044217551618630e+01 1.049044217551618630e+01
1.049044217551618630e+01 1.049044217551618630e+01 1.049044217551618630e+01 2.021653688714377139e+01 2.901029638712745751e+01 3.925372453970049236e+01 5.037006228431695831e+01 5.624953753928834033e+01 5.624953753928834033e+01 5.624953753928834033e+01 5.281984020578320127e+01 4.908865236562887446e+01 4.352539073803197311e+01 3.022485694734229611e+01 2.131223752851666120e+01 1.581130115740249842e+01 1.049044217551618630e+01 1.049044217551618630e+01 1.049044217551618630e+01 1.049044217551618630e+01 1.049044217551618630e+01 1.049044217551618630e+01
1.049044217551618630e+01 1.049044217551618630e+01 1.049044217551618630e+01 1.049044217551618630e+01 2.021653688714377139e+01 2.115673337070694515e+01 2.579756240116949328e+01 2.579756240116949328e+01 2.880761407979230171e+01 2.880761407979230171e+01 2.803345430773394753e+01 2.349537523937534900e+01 2.079276208285052263e+01 2.021653688714377139e+01 1.049044217551618630e+01 1.049044217551618630e+01 1.049044217551618630e+01 1.049044217551618630e+01 1.049044217551618630e+01 1.049044217551618630e+01 1.049044217551618630e+01 1.049044217551618630e+01
