1.063938004582263019e+01 1.063938004582263019e+01 1.063938004582263019e+01 1.063938004582263019e+01 1.063938004582263019e+01 1.063938004582263019e+01 1.063938004582263019e+01 1.063938004582263019e+01 1.063938004582263019e+01 1.063938004582263019e+01 1.063938004582263019e+01 1.063938004582263019e+01 1.063938004582263019e+01 1.063938004582263019e+01 1.063938004582263019e+01 1.063938004582263019e+01 1.063938004582263019e+01 1.063938004582263019e+01 1.063938004582263019e+01 1.063938004582263019e+01 1.063938004582263019e+01 1.063938004582263019e+01
1.063938004582263019e+01 1.063938004582263019e+01 1.063938004582263019e+01 1.063938004582263019e+01 1.063938004582263019e+01 1.063938004582263019e+01 1.063938004582263019e+01 1.063938004582263019e+01 1.063938004582263019e+01 1.063938004582263019e+01 1.063938004582263019e+01 1.063938004582263019e+01 1.063938004582263019e+01 1.063938004582263019e+01 1.063938004582263019e+01 1.063938004582263019e+01 1.063938004582263019e+01 1.063938004582263019e+01 1.063938004582263019e+01 1.063938004582263019e+01 1.063938004582263019e+01 1.063938004582263019e+01
1.063938004582263019e+01 1.063938004582263019e+01 1.063938004582263019e+01 1.063938004582263019e+01 1.063938004582263019e+01 1.063938004582263019e+01 1.063938004582263019e+01 1.063938004582263019e+01 1.063938004582263019e+01 1.063938004582263019e+01 1.655896519822485047e+01 1.900608373408609708e+01 2.305545341130770609e+01 2.305545341130770609e+01 2.305545341130770609e+01 2.305545341130770609e+01 2.305545341130770609e+01 2.305545341130770609e+01 2.211032426572234044e+01 1.063938004582263019e+01 1.063938004582263019e+01 1.063938004582263019e+01
1.063938004582263019e+01 1.063938004582263019e+01 1.063938004582263019e+01 1.063938004582263019e+01 1.063938004582263019e+01 1.063938004582263019e+01 1.063938004582263019e+01 1.063938004582263019e+01 1.900608373408609708e+01 2.511941430769709882e+01 2.830218143730851921e+01 3.907887300165633349e+01 4.226119165025854585e+01 4.161129096022570906e+01 3.994376022693258932e+01 4.386151163191686919e+01 4.386151163191686919e+01 3.668917225327861331e+01 2.792003008836952560e+01 2.446380806349958803e+01 2.112100310091644317e+01 1.063938004582263019e+01
1.063938004582263019e+01 1.063938004582263019e+01 1.063938004582263019e+01 1.063938004582263019e+01 1.063938004582263019e+01 1.655896519822485047e+01 1.900608373408609708e+01 2.511941430769709882e+01 3.524424096444708709e+01 4.226119165025854585e+01 5.336115004905213510e+01 6.011460656064544850e+01 6.011460656064544850e+01 6.011460656064544850e+01 6.011460656064544850e+01 6.011460656064544850e+01 6.011460656064544850e+01 5.483424525774733382e+01 5.483424525774733382e+01 4.161129096022570906e+01 2.792003008836952560e+01 2.112100310091644317e+01
1.063938004582263019e+01 1.063938004582263019e+01 1.063938004582263019e+01 1.900608373408609708e+01 2.535741861672342878e+01 3.089998730993930209e+01 3.907887300165633349e+01 4.999162775636807510e+01 5.452577586694403777e+01 7.290362102931661070e+01 7.290362102931661070e+01 6.855720551867953816e+01 6.141594349919029838e+01 6.141594349919029838e+01 6.141594349919029838e+01 6.141594349919029838e+01 6.141594349919029838e+01 6.141594349919029838e+01 6.011460656064544850e+01 6.011460656064544850e+01 5.483424525774733382e+01 4.161129096022570906e+01
1.063938004582263019e+01 1.629893998170607716e+01 2.300754592466191895e+01 3.112639842769901222e+01 4.475138205042615880e+01 5.821088498948612511e+01 7.290362102931661070e+01 7.290362102931661070e+01 8.333575771516699149e+01 8.125816198330849716e+01 6.606142834189250834e+01 6.141594349919029838e+01 5.259808325520390326e+01 4.917491072157163501e+01 4.092143636724351552e+01 4.092143636724351552e+01 4.092143636724351552e+01 4.973125819003995929e+01 5.655917830142950464e+01 6.855720551867953816e+01 7.437357104700166133e+01 5.937512904124922386e+01
1.063938004582263019e+01 2.203817407130197381e+01 3.146485717344659605e+01 5.188229062355708265e+01 7.290362102931661070e+01 7.579559967287273992e+01 8.645797760279522493e+01 8.645797760279522493e+01 9.190517595187657207e+01 9.228505203939904789e+01 7.415374995926725887e+01 5.193020984520835270e+01 3.777914535122418016e+01 2.910960709983828565e+01 2.582433705053606943e+01 2.582433705053606943e+01 2.467748854121231616e+01 3.142763627768336576e+01 4.403459868819304290e+01 6.300757927800032121e+01 7.929504699057991957e+01 6.451257002351431424e+01
1.746731493780447764e+01 2.664388809324788809e+01 5.386683122221396758e+01 7.497686775504176637e+01 7.752398993097169466e+01 7.761349518442663964e+01 8.486876374399945178e+01 8.095072982516356319e+01 9.154648095463747381e+01 8.403032843992511403e+01 7.308900676402919316e+01 5.483424525774733382e+01 4.386151163191686919e+01 4.386151163191686919e+01 3.668917225327861331e+01 3.668917225327861331e+01 2.792003008836952560e+01 2.691820277537388861e+01 3.599665149271722697e+01 5.030158609100872980e+01 7.929504699057991957e+01 6.790789668325793116e+01
2.179582289431901643e+01 3.932928555408608418e+01 5.799610497848865265e+01 7.752398993097169466e+01 7.415374995926725887e+01 7.160727912679546137e+01 5.626790238431219393e+01 5.906737726124801213e+01 7.461030726255977186e+01 7.563269059294869123e+01 7.563269059294869123e+01 6.187075258725183602e+01 6.011460656064544850e+01 6.011460656064544850e+01 5.483424525774733382e+01 3.483833632527834823e+01 3.777914535122418016e+01 2.910960709983828565e+01 2.746157501403398271e+01 4.669220876493616856e+01 6.855720551867953816e+01 6.187075258725183602e+01
2.203817407130197381e+01 4.699894944545972919e+01 7.349236933924629511e+01 7.761349518442663964e+01 6.466635262479873347e+01 4.070949000364549875e+01 3.483970542282202132e+01 3.458787427178911145e+01 4.718027261037714482e+01 5.522345943391182743e+01 5.530132948171566909e+01 5.530132948171566909e+01 6.141594349919029838e+01 6.141594349919029838e+01 3.969311490101442530e+01 3.969311490101442530e+01 2.910960709983828565e+01 2.624812734525904645e+01 3.497651673022625118e+01 5.222507247243939332e+01 6.855720551867953816e+01 6.790789668325793116e+01
2.605483093361177183e+01 4.699894944545972919e+01 6.855720551867953816e+01 7.415374995926725887e+01 5.502649077287107104e+01 3.010470945274256138e+01 2.292651241626865755e+01 2.324321849530623751e+01 2.254587298193364830e+01 2.863306196066779208e+01 3.466321226492966900e+01 3.483970542282202132e+01 3.483970542282202132e+01 2.880761407979230171e+01 3.060379635601951520e+01 2.880761407979230171e+01 2.355623191844375697e+01 2.746157501403398271e+01 4.642393965294979097e+01 5.188229062355708265e+01 7.497686775504176637e+01 5.502649077287107104e+01
2.605483093361177183e+01 5.195673014182366956e+01 7.929504699057991957e+01 7.415374995926725887e+01 5.085644369324204206e+01 2.069123452523976070e+01 1.587115357344561772e+01 1.063938004582263019e+01 1.587115357344561772e+01 1.587115357344561772e+01 1.587115357344561772e+01 1.587115357344561772e+01 2.311371552617554670e+01 1.587115357344561772e+01 1.883172623652409428e+01 1.883172623652409428e+01 2.179582289431901643e+01 3.536048863166180212e+01 5.188229062355708265e+01 7.497686775504176637e+01 6.141594349919029838e+01 5.175868361855789601e+01
2.605483093361177183e+01 5.435147185307322104e+01 7.929504699057991957e+01 6.790789668325793116e+01 5.085644369324204206e+01 2.069123452523976070e+01 1.063938004582263019e+01 1.063938004582263019e+01 1.063938004582263019e+01 1.063938004582263019e+01 1.063938004582263019e+01 1.063938004582263019e+01 1.063938004582263019e+01 1.063938004582263019e+01 1.629893998170607716e+01 2.351133573865289961e+01 3.845897191771771872e+01 5.188229062355708265e+01 7.497686775504176637e+01 7.752398993097169466e+01 5.502649077287107104e+01 3.185174047389404706e+01
2.605483093361177183e+01 5.030158609100872980e+01 7.929504699057991957e+01 7.308900676402919316e+01 5.514803619475235763e+01 2.521322112677976790e+01 1.063938004582263019e+01 1.063938004582263019e+01 1.063938004582263019e+01 1.063938004582263019e+01 1.063938004582263019e+01 1.063938004582263019e+01 1.063938004582263019e+01 1.900608373408609708e+01 2.535741861672342878e+01 3.790419621841178355e+01 5.188229062355708265e+01 7.497686775504176637e+01 7.752398993097169466e+01 6.466635262479873347e+01 4.299171655663895564e+01 2.476792985486370213e+01
2.437297576376334618e+01 5.030158609100872980e+01 7.262139152702894762e+01 8.403032843992511403e+01 6.606142834189250834e+01 3.555502952937794703e+01 2.112100310091644317e+01 1.655896519822485047e+01 1.063938004582263019e+01 1.063938004582263019e+01 1.063938004582263019e+01 1.900608373408609708e+01 2.300754592466191895e+01 3.112639842769901222e+01 3.790419621841178355e+01 5.188229062355708265e+01 6.855720551867953816e+01 7.752398993097169466e+01 6.141594349919029838e+01 4.753789964726387041e+01 2.957998669133371550e+01 2.009397188794036637e+01
2.116666946119428871e+01 3.599665149271722697e+01 6.300757927800032121e+01 8.095072982516356319e+01 6.790789668325793116e+01 5.483424525774733382e+01 3.432992398976886506e+01 2.814246665213499554e+01 2.305545341130770609e+01 2.305545341130770609e+01 2.305545341130770609e+01 3.019251372131649802e+01 4.226119165025854585e+01 5.188229062355708265e+01 6.011460656064544850e+01 7.497686775504176637e+01 6.141594349919029838e+01 6.141594349919029838e+01 4.108889643317800733e+01 2.730456362592222774e+01 2.059756021920894398e+01 1.063938004582263019e+01
1.063938004582263019e+01 2.989171542845337370e+01 4.777899243206440616e+01 6.520853516644879733e+01 7.752398993097169466e+01 6.606142834189250834e+01 5.483424525774733382e+01 4.386151163191686919e+01 4.386151163191686919e+01 3.654695041814376566e+01 4.226119165025854585e+01 4.612815827777500033e+01 5.188229062355708265e+01 7.497686775504176637e+01 6.141594349919029838e+01 6.141594349919029838e+01 5.209694645957232240e+01 3.658643083491170245e+01 2.613463092226445994e+01 2.059756021920894398e+01 1.063938004582263019e+01 1.063938004582263019e+01
1.063938004582263019e+01 2.116666946119428871e+01 3.550256102698680394e+01 4.836527725908968023e+01 5.655917830142950464e+01 6.141594349919029838e+01 6.011460656064544850e+01 6.011460656064544850e+01 6.011460656064544850e+01 6.011460656064544850e+01 6.011460656064544850e+01 6.011460656064544850e+01 6.141594349919029838e+01 6.141594349919029838e+01 5.530132948171566909e+01 4.683028878787614246e+01 3.188185523178569625e+01 2.059756021920894398e+01 1.063938004582263019e+01 1.063938004582263019e+01 1.063938004582263019e+01 1.063938004582263019e+01
1.063938004582263019e+01 1.063938004582263019e+01 2.116666946119428871e+01 3.207241544461427907e+01 3.458787427178911145e+01 5.522345943391182743e+01 5.522345943391182743e+01 6.141594349919029838e+01 6.141594349919029838e+01 6.141594349919029838e+01 6.141594349919029838e+01 5.259808325520390326e+01 4.718027261037714482e+01 4.092143636724351552e+01 3.188185523178569625e+01 2.613463092226445994e+01 2.059756021920894398e+01 1.063938004582263019e+01 1.063938004582263019e+01 1.063938004582263019e+01 1.063938004582263019e+01 1.063938004582263019e+01
1.063938004582263019e+01 1.063938004582263019e+01 1.063938004582263019e+01 2.116666946119428871e+01 2.324321849530623751e+01 3.458787427178911145e+01 3.466321226492966900e+01 4.092143636724351552e+01 4.092143636724351552e+01 4.092143636724351552e+01 4.092143636724351552e+01 3.188185523178569625e+01 2.703685485521691945e+01 2.292651241626865755e+01 2.059756021920894398e+01 1.411668100629406375e+01 1.063938004582263019e+01 1.063938004582263019e+01 1.063938004582263019e+01 1.063938004582263019e+01 1.063938004582263019e+01 1.063938004582263019e+01
1.063938004582263019e+01 1.063938004582263019e+01 1.063938004582263019e+01 1.063938004582263019e+01 1.063938004582263019e+01 1.587115357344561772e+01 2.292651241626865755e+01 2.292651241626865755e+01 2.292651241626865755e+01 2.292651241626865755e+01 2.292651241626865755e+01 2.059756021920894398e+01 1.587115357344561772e+01 1.063938004582263019e+01 1.063938004582263019e+01 1.063938004582263019e+01 1.063938004582263019e+01 1.063938004582263019e+01 1.063938004582263019e+01 1.063938004582263019e+01 1.063938004582263019e+01 1.063938004582263019e+01
