1.050435867992292494e+01 1.050435867992292494e+01 1.050435867992292494e+01 1.050435867992292494e+01 1.050435867992292494e+01 1.050435867992292494e+01 1.050435867992292494e+01 1.050435867992292494e+01 1.991310736778258672e+01 2.135024088547363164e+01 2.512597921420759661e+01 2.537736288041359245e+01 3.017579980843416010e+01 2.830120131461937660e+01 2.948239190137699950e+01 2.830120131461937660e+01 2.948239190137699950e+01 2.119360727617175044e+01 2.119360727617175044e+01 1.050435867992292494e+01 1.050435867992292494e+01 1.050435867992292494e+01
1.050435867992292494e+01 1.050435867992292494e+01 1.050435867992292494e+01 1.050435867992292494e+01 1.050435867992292494e+01 1.050435867992292494e+01 1.991310736778258672e+01 2.512597921420759661e+01 3.604258471189580604e+01 4.230632157188551901e+01 5.452577586694403777e+01 5.452577586694403777e+01 5.792027839251110777e+01 5.792027839251110777e+01 6.607589180596177414e+01 5.792027839251110777e+01 5.792027839251110777e+01 4.298453589303452560e+01 2.935098832648340306e+01 2.013145738725555489e+01 1.050435867992292494e+01 1.050435867992292494e+01
1.050435867992292494e+01 1.050435867992292494e+01 1.050435867992292494e+01 1.050435867992292494e+01 1.050435867992292494e+01 2.153650285939491837e+01 3.655918591624698166e+01 4.999162775636807510e+01 6.607589180596177414e+01 7.290362102931661070e+01 8.197480627824124610e+01 8.849463623698140680e+01 9.519488692179210432e+01 9.585940618928657386e+01 9.835894512594049388e+01 9.585940618928657386e+01 9.458474086662928926e+01 7.303715295658162177e+01 5.761308413963682540e+01 3.025936968457882159e+01 2.013145738725555489e+01 1.050435867992292494e+01
1.050435867992292494e+01 1.050435867992292494e+01 1.050435867992292494e+01 1.050435867992292494e+01 2.153650285939491837e+01 4.038818582854847961e+01 5.920202410051773256e+01 8.398778897932785981e+01 9.585940618928657386e+01 9.761241053255834288e+01 1.057596942414970727e+02 1.057596942414970727e+02 1.096000304450039948e+02 1.052333821813460304e+02 1.052333821813460304e+02 1.049039880288428037e+02 1.119837381509712202e+02 1.007337887580142421e+02 8.241584257593706297e+01 4.588841205490970765e+01 2.567015351301001758e+01 1.050435867992292494e+01
1.050435867992292494e+01 1.050435867992292494e+01 1.050435867992292494e+01 1.991310736778258672e+01 3.729886400005740654e+01 6.634852645776632585e+01 8.422874325894495939e+01 1.046628191045949023e+02 1.114457706143415976e+02 1.078745129957559215e+02 9.039412377453218994e+01 9.502585619177121146e+01 9.502585619177121146e+01 8.685000700503995574e+01 8.112868806891556517e+01 8.891750993061160102e+01 1.039879958159259701e+02 1.024960226548022888e+02 9.217435410122803319e+01 6.003675340934887572e+01 3.011660708635344719e+01 1.050435867992292494e+01
1.050435867992292494e+01 1.050435867992292494e+01 1.050435867992292494e+01 2.487014464207499742e+01 5.578573843009480271e+01 8.534169260253071343e+01 1.026167154108456998e+02 1.152434134491005437e+02 1.045996698552216628e+02 7.755118672539367708e+01 6.598004956872136972e+01 6.816038285907404770e+01 6.714297043548006627e+01 6.598004956872136972e+01 6.324191401819631153e+01 6.186422396667725820e+01 9.105918778449346007e+01 9.906947983654964673e+01 9.535180925751495806e+01 6.616659472262693953e+01 3.375626554058978002e+01 1.935590519696998868e+01
1.050435867992292494e+01 1.050435867992292494e+01 1.746019940726076314e+01 3.592354097194406393e+01 6.617916046282134346e+01 9.889320879486335514e+01 1.188686626656459140e+02 1.119919885900531540e+02 8.510245218938416656e+01 5.665476014420391238e+01 3.700030992227245008e+01 3.678747120766308143e+01 4.099500703359595377e+01 3.635435829187767354e+01 3.760376993283141900e+01 5.730852893233635825e+01 8.724990224384166027e+01 9.941135384387433760e+01 9.465368824152768923e+01 6.261652284293026582e+01 3.175221247663955637e+01 1.935590519696998868e+01
1.050435867992292494e+01 1.050435867992292494e+01 2.015026756361512739e+01 3.684407484630823859e+01 7.599295858235142020e+01 9.995566344459986396e+01 1.194006375075505559e+02 1.004070209996665994e+02 7.049869490066110700e+01 4.340632434380852800e+01 3.138765089314915713e+01 3.148223429879864810e+01 3.148223429879864810e+01 4.139904611284603675e+01 5.196963755964671350e+01 7.350414531752647918e+01 9.341640621041497639e+01 9.747673081825843155e+01 8.081736219213949823e+01 5.064403422730880777e+01 2.554709563449646481e+01 1.050435867992292494e+01
1.050435867992292494e+01 1.050435867992292494e+01 2.015026756361512739e+01 3.839806761630147491e+01 6.896629038657412991e+01 9.995566344459986396e+01 1.222726101420641243e+02 1.022215173366967349e+02 8.241584257593706297e+01 5.114420120664814107e+01 4.709959576975492013e+01 4.756463616943907624e+01 5.534715119741370160e+01 6.607589180596177414e+01 7.980317986468796221e+01 8.471941509252448554e+01 9.765868052318273840e+01 8.695106297109035154e+01 7.044475661870544059e+01 4.167586457676208056e+01 2.298310272679284694e+01 1.050435867992292494e+01
1.050435867992292494e+01 1.050435867992292494e+01 1.050435867992292494e+01 3.242750076595780939e+01 6.132993184897038219e+01 9.098065443204625069e+01 1.102358725322514488e+02 1.101107541278961151e+02 9.118238354928705292e+01 7.882506888120558131e+01 7.601663645499561994e+01 8.849463623698140680e+01 9.835894512594049388e+01 9.835894512594049388e+01 9.383302472179616416e+01 9.712258285992129458e+01 8.630802829008192134e+01 7.108222216307075314e+01 4.527825277422861916e+01 2.554709563449646481e+01 1.986423608768883753e+01 1.050435867992292494e+01
1.050435867992292494e+01 1.050435867992292494e+01 1.050435867992292494e+01 2.440327033244665955e+01 4.692982431347663663e+01 8.071193698427848062e+01 1.074505028081019162e+02 1.119837381509712202e+02 1.240415228443710305e+02 1.202340611812947913e+02 1.117527680697920260e+02 1.202340611812947913e+02 1.286421035822047259e+02 1.281797176753564429e+02 1.281797176753564429e+02 9.793494663249246912e+01 7.578851138293673273e+01 4.753789964726387041e+01 2.854609804890466407e+01 1.581130115740249842e+01 1.050435867992292494e+01 1.050435867992292494e+01
1.050435867992292494e+01 1.050435867992292494e+01 1.050435867992292494e+01 2.115673337070694515e+01 3.765860333556002360e+01 6.914307303127056059e+01 1.026459358858047040e+02 1.163311013987630957e+02 1.296830303946209995e+02 1.302376191694999079e+02 1.350542072522559920e+02 1.350542072522559920e+02 1.445084143242438017e+02 1.445084143242438017e+02 1.305818884722979760e+02 1.022215173366967349e+02 7.342590993661410437e+01 4.047374110711054840e+01 2.169813742288533120e+01 1.050435867992292494e+01 1.050435867992292494e+01 1.050435867992292494e+01
1.050435867992292494e+01 1.050435867992292494e+01 1.050435867992292494e+01 1.746019940726076314e+01 3.030191442573751104e+01 5.730852893233635825e+01 8.724990224384166027e+01 1.203210698816197066e+02 1.326693142597768258e+02 1.246182494969465893e+02 1.183614542096221811e+02 1.228015672572324206e+02 1.272384443420621665e+02 1.366777644830550287e+02 1.320018896627516938e+02 1.022215173366967349e+02 8.241584257593706297e+01 4.588841205490970765e+01 2.521322112677976790e+01 1.050435867992292494e+01 1.050435867992292494e+01 1.050435867992292494e+01
1.050435867992292494e+01 1.050435867992292494e+01 1.050435867992292494e+01 1.746019940726076314e+01 3.047931416392753334e+01 6.076263038747750755e+01 9.889320879486335514e+01 1.108716367342830438e+02 1.162313143841701901e+02 9.868036232457166079e+01 9.502585619177121146e+01 9.502585619177121146e+01 9.502585619177121146e+01 1.112646968057098888e+02 1.222726101420641243e+02 1.101107541278961151e+02 9.217435410122803319e+01 6.659787043424640274e+01 3.955455334013480240e+01 1.906548892319178989e+01 1.050435867992292494e+01 1.050435867992292494e+01
1.050435867992292494e+01 1.050435867992292494e+01 1.050435867992292494e+01 2.015026756361512739e+01 4.302597914696107750e+01 6.980948091781502285e+01 1.026167154108456998e+02 1.114457706143415976e+02 9.408299420081142728e+01 6.676847671881647273e+01 5.530747119206352380e+01 5.624953753928834033e+01 6.816038285907404770e+01 7.818406345734186402e+01 9.986594272496968472e+01 1.102358725322514488e+02 1.101107541278961151e+02 8.115933238044293319e+01 4.628944932260192502e+01 2.318502891486033590e+01 1.050435867992292494e+01 1.050435867992292494e+01
1.050435867992292494e+01 1.050435867992292494e+01 1.050435867992292494e+01 2.432440471747656829e+01 4.944524398532483644e+01 8.504925111423925443e+01 1.028228159586397084e+02 1.027037850100975476e+02 7.649356468368729622e+01 4.396290479319647915e+01 2.880761407979230171e+01 2.863306196066779208e+01 3.602943098878326111e+01 5.745317212735775314e+01 8.203267464890822680e+01 1.074505028081019162e+02 1.066112615516707933e+02 8.115933238044293319e+01 5.085644369324204206e+01 2.502112501368190678e+01 1.050435867992292494e+01 1.050435867992292494e+01
1.050435867992292494e+01 1.050435867992292494e+01 1.050435867992292494e+01 2.511813064691547481e+01 5.431123113993275098e+01 8.504925111423925443e+01 1.088015873682298462e+02 1.066112615516707933e+02 7.324171881884836921e+01 3.509631159257600075e+01 2.122919326472124268e+01 2.039030561777367723e+01 3.436808816940254019e+01 5.030158609100872980e+01 7.611920035724862998e+01 1.005806623717835606e+02 9.924698512481182888e+01 8.137091400200536384e+01 4.422495564401341994e+01 2.376997270242555516e+01 1.050435867992292494e+01 1.050435867992292494e+01
1.050435867992292494e+01 1.050435867992292494e+01 1.050435867992292494e+01 2.435920895946700071e+01 4.735107366498647963e+01 8.844806095342228502e+01 1.074505028081019162e+02 1.101107541278961151e+02 8.241584257593706297e+01 5.159184330117459893e+01 3.670259630888821079e+01 3.088957685670802888e+01 4.478423062541608601e+01 6.249927297860704556e+01 9.006336536763862455e+01 9.765868052318273840e+01 9.526376062215697971e+01 6.882399794553158756e+01 3.861712662933616258e+01 1.906548892319178989e+01 1.050435867992292494e+01 1.050435867992292494e+01
1.050435867992292494e+01 1.050435867992292494e+01 1.050435867992292494e+01 2.115673337070694515e+01 4.363721486251355941e+01 7.548157082825299824e+01 1.026459358858047040e+02 1.119837381509712202e+02 1.036412152220773777e+02 7.882506888120558131e+01 5.792027839251110777e+01 6.607589180596177414e+01 6.944894883599411628e+01 8.458739058307916991e+01 9.484831745033733341e+01 9.229863728258497702e+01 7.522450124572942798e+01 5.012678185559355626e+01 2.554709563449646481e+01 1.581130115740249842e+01 1.050435867992292494e+01 1.050435867992292494e+01
1.050435867992292494e+01 1.050435867992292494e+01 1.050435867992292494e+01 1.050435867992292494e+01 2.765107264361366290e+01 5.961319197637604361e+01 8.844806095342228502e+01 9.986594272496968472e+01 1.119837381509712202e+02 1.071515851078959543e+02 9.458474086662928926e+01 9.585940618928657386e+01 9.383302472179616416e+01 9.765868052318273840e+01 9.583069483576340986e+01 7.522450124572942798e+01 5.012678185559355626e+01 2.954319764823609873e+01 2.131223752851666120e+01 1.050435867992292494e+01 1.050435867992292494e+01 1.050435867992292494e+01
1.050435867992292494e+01 1.050435867992292494e+01 1.050435867992292494e+01 1.050435867992292494e+01 2.115673337070694515e+01 3.765860333556002360e+01 6.307626278538046449e+01 8.891750993061160102e+01 1.034888002628461123e+02 1.052333821813460304e+02 1.052333821813460304e+02 1.052333821813460304e+02 1.024642989574734742e+02 9.039412377453218994e+01 7.462082514752911777e+01 5.082409935864987460e+01 3.358756149937117641e+01 2.131223752851666120e+01 1.050435867992292494e+01 1.050435867992292494e+01 1.050435867992292494e+01 1.050435867992292494e+01
1.050435867992292494e+01 1.050435867992292494e+01 1.050435867992292494e+01 1.050435867992292494e+01 1.050435867992292494e+01 2.901029638712745751e+01 4.615947559395595334e+01 6.520853516644879733e+01 7.916028661083466034e+01 8.112868806891556517e+01 9.502585619177121146e+01 8.250853467910826566e+01 7.581138759358364609e+01 6.090182459430330653e+01 4.527825277422861916e+01 3.022485694734229611e+01 2.131223752851666120e+01 1.581130115740249842e+01 1.050435867992292494e+01 1.050435867992292494e+01 1.050435867992292494e+01 1.050435867992292494e+01
