1.058817654202833403e+01 1.058817654202833403e+01 1.058817654202833403e+01 1.058817654202833403e+01 1.058817654202833403e+01 1.058817654202833403e+01 1.058817654202833403e+01 1.058817654202833403e+01 1.900608373408609708e+01 2.524379365679111942e+01 4.474049198257514348e+01 5.452577586694403777e+01 5.643303532610476481e+01 5.560801958488017505e+01 5.162282319978789502e+01 3.991979863582817956e+01 2.446380806349958803e+01 2.112100310091644317e+01 1.058817654202833403e+01 1.058817654202833403e+01 1.058817654202833403e+01 1.058817654202833403e+01
1.058817654202833403e+01 1.058817654202833403e+01 1.058817654202833403e+01 1.058817654202833403e+01 1.058817654202833403e+01 1.058817654202833403e+01 1.058817654202833403e+01 1.629893998170607716e+01 2.733660330410323525e+01 4.582138949894616076e+01 7.123321647226035225e+01 8.463129576091790796e+01 1.015770367540467447e+02 8.996627041103823785e+01 8.448826993091901727e+01 6.524542418453975756e+01 5.560801958488017505e+01 3.769266979682478080e+01 2.112100310091644317e+01 1.058817654202833403e+01 1.058817654202833403e+01 1.058817654202833403e+01
1.058817654202833403e+01 1.058817654202833403e+01 1.058817654202833403e+01 1.058817654202833403e+01 1.058817654202833403e+01 1.058817654202833403e+01 1.058817654202833403e+01 2.203817407130197381e+01 3.932928555408608418e+01 6.634852645776632585e+01 9.744039262810701985e+01 1.202340611812947913e+02 1.337504730726667503e+02 1.240581687786764462e+02 1.240581687786764462e+02 9.430693125385545272e+01 8.467499928512181384e+01 6.524542418453975756e+01 3.769266979682478080e+01 2.112100310091644317e+01 1.058817654202833403e+01 1.058817654202833403e+01
1.058817654202833403e+01 1.058817654202833403e+01 1.058817654202833403e+01 1.058817654202833403e+01 1.058817654202833403e+01 1.058817654202833403e+01 1.058817654202833403e+01 2.533488636311268394e+01 4.944524398532483644e+01 8.383253452420063923e+01 1.126988708127875611e+02 1.350542072522559920e+02 1.380293315845498796e+02 1.380293315845498796e+02 1.330472910713177725e+02 1.345219674554894880e+02 1.240581687786764462e+02 1.007301868990298885e+02 6.524542418453975756e+01 3.955455334013480240e+01 2.068965660650491856e+01 1.058817654202833403e+01
1.058817654202833403e+01 1.058817654202833403e+01 1.058817654202833403e+01 1.058817654202833403e+01 1.058817654202833403e+01 1.058817654202833403e+01 1.747229851364820874e+01 3.478596223621899242e+01 6.587502352873488576e+01 1.005758033723891742e+02 1.222140263662451360e+02 1.367166715461557374e+02 1.367166715461557374e+02 1.367166715461557374e+02 1.342891948232164054e+02 1.350542072522559920e+02 1.337504730726667503e+02 1.181763214611665802e+02 8.467499928512181384e+01 5.062853750199955982e+01 2.521322112677976790e+01 1.058817654202833403e+01
1.058817654202833403e+01 1.058817654202833403e+01 1.058817654202833403e+01 1.058817654202833403e+01 1.058817654202833403e+01 1.629893998170607716e+01 2.733660330410323525e+01 4.664474702559211039e+01 8.383253452420063923e+01 1.126988708127875611e+02 1.267937138529195522e+02 1.150539480660322624e+02 1.009394645919377638e+02 1.112254356764767067e+02 1.146197973337151126e+02 1.311593938932073229e+02 1.380293315845498796e+02 1.246568126045170288e+02 9.215144366710956092e+01 6.659787043424640274e+01 3.555502952937794703e+01 1.986201975360099325e+01
1.058817654202833403e+01 1.058817654202833403e+01 1.058817654202833403e+01 1.058817654202833403e+01 1.058817654202833403e+01 2.348181438849669078e+01 3.845897191771771872e+01 6.634852645776632585e+01 1.026079531314010467e+02 1.209010301798637101e+02 1.167199747869326814e+02 9.329797271193744734e+01 7.045481567091425745e+01 7.461030726255977186e+01 8.071193698427848062e+01 1.146197973337151126e+02 1.311593938932073229e+02 1.303874815754411998e+02 1.181763214611665802e+02 8.467499928512181384e+01 3.955455334013480240e+01 2.068965660650491856e+01
1.058817654202833403e+01 1.058817654202833403e+01 1.058817654202833403e+01 1.058817654202833403e+01 2.300754592466191895e+01 3.845897191771771872e+01 6.249927297860704556e+01 9.543139221029323949e+01 1.180464787768845127e+02 1.243954650720609862e+02 1.046095375213686225e+02 7.718937773911142131e+01 4.753789964726387041e+01 4.543984088281586509e+01 5.986805291352521152e+01 8.844806095342228502e+01 1.146197973337151126e+02 1.350542072522559920e+02 1.246568126045170288e+02 9.215144366710956092e+01 5.062853750199955982e+01 2.521322112677976790e+01
1.058817654202833403e+01 1.058817654202833403e+01 1.058817654202833403e+01 1.900608373408609708e+01 3.068724849374920538e+01 5.390231621194758560e+01 8.399173636046521096e+01 1.115631937396772031e+02 1.243954650720609862e+02 1.119919885900531540e+02 7.656393884381867565e+01 5.013117464565002024e+01 2.924874848204395050e+01 2.086604990849175323e+01 3.399009257377374382e+01 6.667537697573112609e+01 1.146197973337151126e+02 1.273827525680532489e+02 1.321622939639670449e+02 1.002094696830131966e+02 6.616659472262693953e+01 3.555502952937794703e+01
1.058817654202833403e+01 1.058817654202833403e+01 1.058817654202833403e+01 2.450972669612315968e+01 4.664474702559211039e+01 7.812615969989629150e+01 1.115631937396772031e+02 1.209010301798637101e+02 1.167199747869326814e+02 9.827625783003466609e+01 6.443409132973967246e+01 3.185174047389404706e+01 2.059756021920894398e+01 1.477501355225733981e+01 2.437963185123078347e+01 5.435147185307322104e+01 8.844806095342228502e+01 1.222140263662451360e+02 1.321622939639670449e+02 1.145029388046262397e+02 8.044097608266105226e+01 4.047374110711054840e+01
1.058817654202833403e+01 1.058817654202833403e+01 2.203817407130197381e+01 3.478596223621899242e+01 6.587502352873488576e+01 1.005758033723891742e+02 1.209010301798637101e+02 1.243954650720609862e+02 1.046095375213686225e+02 7.718937773911142131e+01 4.515683160324910972e+01 2.196921211170429444e+01 1.477501355225733981e+01 1.058817654202833403e+01 2.437963185123078347e+01 4.521695829142818468e+01 7.686980701091836465e+01 1.222140263662451360e+02 1.290614432856006886e+02 1.145029388046262397e+02 8.044097608266105226e+01 4.017475178599606522e+01
1.058817654202833403e+01 1.629893998170607716e+01 2.533488636311268394e+01 4.956987567206795120e+01 8.383253452420063923e+01 1.126988708127875611e+02 1.243954650720609862e+02 1.123033073518704725e+02 8.672386409757240244e+01 5.599928707936813765e+01 2.924874848204395050e+01 2.009397188794036637e+01 1.058817654202833403e+01 1.058817654202833403e+01 2.203817407130197381e+01 4.803904253953125902e+01 7.997149390320140583e+01 1.105898691532984657e+02 1.290614432856006886e+02 1.037359330748180639e+02 6.922702336370514331e+01 3.860850823494484274e+01
1.058817654202833403e+01 2.163339702073119497e+01 3.478596223621899242e+01 6.618081628259152183e+01 1.005758033723891742e+02 1.209010301798637101e+02 1.167199747869326814e+02 8.880468889748023287e+01 6.090034100386655069e+01 3.185174047389404706e+01 2.059756021920894398e+01 1.058817654202833403e+01 1.058817654202833403e+01 1.629893998170607716e+01 3.068724849374920538e+01 6.076222602503586501e+01 9.543139221029323949e+01 1.180464787768845127e+02 1.167199747869326814e+02 9.827625783003466609e+01 5.599928707936813765e+01 3.057274840746227440e+01
1.058817654202833403e+01 2.533488636311268394e+01 4.956987567206795120e+01 8.383253452420063923e+01 1.126988708127875611e+02 1.206195832775574956e+02 1.059653799613593321e+02 6.885392829603243570e+01 3.860850823494484274e+01 2.196921211170429444e+01 1.477501355225733981e+01 1.058817654202833403e+01 1.900608373408609708e+01 2.524379365679111942e+01 4.664474702559211039e+01 7.123321647226035225e+01 1.068377069546734646e+02 1.147462866455597208e+02 1.074737657676030977e+02 7.718937773911142131e+01 4.515683160324910972e+01 2.196921211170429444e+01
1.058817654202833403e+01 2.965542249945050557e+01 5.992511861684114649e+01 1.005758033723891742e+02 1.209010301798637101e+02 1.235464314053882049e+02 9.588722799739498726e+01 6.683493845984837378e+01 3.334662995605850000e+01 2.158319413813923759e+01 1.900608373408609708e+01 2.511941430769709882e+01 3.604258471189580604e+01 4.999162775636807510e+01 7.439968506770806300e+01 9.744039262810701985e+01 1.174544413156549325e+02 1.167199747869326814e+02 9.827625783003466609e+01 5.599928707936813765e+01 3.057274840746227440e+01 2.009397188794036637e+01
1.747229851364820874e+01 3.291018196360149517e+01 6.979334712493732695e+01 1.070291333056488838e+02 1.350542072522559920e+02 1.246568126045170288e+02 9.215144366710956092e+01 6.632515958044005799e+01 3.769266979682478080e+01 3.309754005061930826e+01 4.006012177545483155e+01 4.755656603440925778e+01 6.365873111549836239e+01 8.463129576091790796e+01 9.933389732208242151e+01 1.174544413156549325e+02 1.243954650720609862e+02 1.059653799613593321e+02 8.085890981424391555e+01 4.515683160324910972e+01 2.196921211170429444e+01 1.058817654202833403e+01
1.747229851364820874e+01 3.291018196360149517e+01 6.979334712493732695e+01 1.134097903845594004e+02 1.350542072522559920e+02 1.321622939639670449e+02 1.099044114587568401e+02 8.467499928512181384e+01 7.331484543287757560e+01 7.331484543287757560e+01 7.331484543287757560e+01 8.688729523718323833e+01 9.933389732208242151e+01 1.088570908412267073e+02 1.198138880674060402e+02 1.243954650720609862e+02 1.123033073518704725e+02 8.672386409757240244e+01 5.693323320372491736e+01 3.057274840746227440e+01 2.009397188794036637e+01 1.058817654202833403e+01
1.058817654202833403e+01 3.218847632818508231e+01 6.300757927800032121e+01 9.169328567036720301e+01 1.273827525680532489e+02 1.380293315845498796e+02 1.240581687786764462e+02 1.099044114587568401e+02 1.015770367540467447e+02 1.015770367540467447e+02 1.117527680697920260e+02 1.117527680697920260e+02 1.198138880674060402e+02 1.206195832775574956e+02 1.150539480660322624e+02 1.095347812652294266e+02 8.672386409757240244e+01 5.693323320372491736e+01 3.358529083165833384e+01 2.059756021920894398e+01 1.058817654202833403e+01 1.058817654202833403e+01
1.058817654202833403e+01 2.437963185123078347e+01 4.403459868819304290e+01 7.548157082825299824e+01 1.146197973337151126e+02 1.311593938932073229e+02 1.330472910713177725e+02 1.330472910713177725e+02 1.330472910713177725e+02 1.330472910713177725e+02 1.330472910713177725e+02 1.267937138529195522e+02 1.243954650720609862e+02 1.150539480660322624e+02 9.868036232457166079e+01 8.672386409757240244e+01 5.121301534197040439e+01 3.358529083165833384e+01 2.059756021920894398e+01 1.477501355225733981e+01 1.058817654202833403e+01 1.058817654202833403e+01
1.058817654202833403e+01 2.116666946119428871e+01 3.399009257377374382e+01 5.986805291352521152e+01 8.766901598615110913e+01 1.039951951366592482e+02 1.183398031530065140e+02 1.183398031530065140e+02 1.183398031530065140e+02 1.156397487425466153e+02 1.183398031530065140e+02 1.183398031530065140e+02 1.009394645919377638e+02 8.629186049575979212e+01 6.222008278464129916e+01 4.527270564797198205e+01 3.158643443205587076e+01 2.059756021920894398e+01 1.477501355225733981e+01 1.058817654202833403e+01 1.058817654202833403e+01 1.058817654202833403e+01
1.058817654202833403e+01 1.058817654202833403e+01 2.116666946119428871e+01 3.550256102698680394e+01 4.902608656686890498e+01 6.520853516644879733e+01 7.708298046991414765e+01 8.557873596647132786e+01 8.557873596647132786e+01 8.557873596647132786e+01 8.629186049575979212e+01 8.629186049575979212e+01 6.222008278464129916e+01 4.869210909463576087e+01 3.866215875164099458e+01 2.704098243440429883e+01 2.059756021920894398e+01 1.058817654202833403e+01 1.058817654202833403e+01 1.058817654202833403e+01 1.058817654202833403e+01 1.058817654202833403e+01
1.058817654202833403e+01 1.058817654202833403e+01 1.058817654202833403e+01 2.323289251769909569e+01 2.254587298193364830e+01 3.925334794844203401e+01 4.629551986485846982e+01 5.626790238431219393e+01 5.626790238431219393e+01 5.626790238431219393e+01 5.626790238431219393e+01 4.908544529942793133e+01 3.188185523178569625e+01 2.704098243440429883e+01 2.059756021920894398e+01 1.587286072151143657e+01 1.058817654202833403e+01 1.058817654202833403e+01 1.058817654202833403e+01 1.058817654202833403e+01 1.058817654202833403e+01 1.058817654202833403e+01
