1.069387026374835870e+01 1.069387026374835870e+01 1.069387026374835870e+01 1.069387026374835870e+01 1.069387026374835870e+01 1.069387026374835870e+01 1.069387026374835870e+01 1.069387026374835870e+01 1.069387026374835870e+01 1.069387026374835870e+01 1.069387026374835870e+01 1.069387026374835870e+01 1.069387026374835870e+01 1.069387026374835870e+01 1.069387026374835870e+01 1.069387026374835870e+01 1.069387026374835870e+01 1.069387026374835870e+01 1.069387026374835870e+01 1.634513070875151897e+01 1.634513070875151897e+01 1.666252139879173555e+01
1.069387026374835870e+01 1.069387026374835870e+01 1.069387026374835870e+01 1.069387026374835870e+01 1.069387026374835870e+01 1.069387026374835870e+01 1.069387026374835870e+01 1.069387026374835870e+01 1.069387026374835870e+01 1.069387026374835870e+01 1.069387026374835870e+01 1.069387026374835870e+01 1.069387026374835870e+01 1.069387026374835870e+01 1.069387026374835870e+01 1.634513070875151897e+01 1.634513070875151897e+01 2.351133573865289961e+01 2.511941430769709882e+01 2.830120131461937660e+01 3.538237283133312872e+01 2.446380806349958803e+01
1.069387026374835870e+01 1.069387026374835870e+01 1.069387026374835870e+01 1.069387026374835870e+01 1.069387026374835870e+01 1.069387026374835870e+01 1.069387026374835870e+01 1.069387026374835870e+01 1.069387026374835870e+01 1.069387026374835870e+01 1.634513070875151897e+01 2.351133573865289961e+01 2.535741861672342878e+01 2.579588006004116352e+01 2.579588006004116352e+01 2.830120131461937660e+01 3.538237283133312872e+01 3.907887300165633349e+01 4.830820734801319105e+01 5.560900289945907815e+01 5.670634964716585813e+01 5.005075689286388041e+01
1.069387026374835870e+01 1.069387026374835870e+01 1.069387026374835870e+01 1.069387026374835870e+01 1.069387026374835870e+01 1.069387026374835870e+01 1.069387026374835870e+01 1.069387026374835870e+01 1.654713746148710385e+01 2.334865732325364363e+01 2.619207513488977312e+01 3.907887300165633349e+01 4.707763008116838677e+01 4.941279296947872979e+01 5.624282119241358657e+01 5.624282119241358657e+01 5.670634964716585813e+01 6.050996858600787220e+01 7.321425083654708033e+01 8.315774622338757638e+01 8.051937075894625195e+01 6.524542418453975756e+01
1.069387026374835870e+01 1.069387026374835870e+01 1.069387026374835870e+01 1.069387026374835870e+01 1.069387026374835870e+01 1.069387026374835870e+01 1.069387026374835870e+01 1.069387026374835870e+01 2.050493429340830076e+01 3.201528742034219732e+01 4.624398948143615939e+01 6.505315259451353427e+01 7.321425083654708033e+01 7.767406870236351324e+01 8.251044726759214143e+01 8.315774622338757638e+01 8.315774622338757638e+01 8.333575771516699149e+01 8.907929458861546834e+01 8.907929458861546834e+01 7.987226995532225260e+01 6.807835975089156477e+01
1.069387026374835870e+01 1.069387026374835870e+01 1.069387026374835870e+01 1.069387026374835870e+01 1.069387026374835870e+01 1.069387026374835870e+01 1.069387026374835870e+01 1.069387026374835870e+01 2.235416072387651454e+01 3.536048863166180212e+01 6.280681974623880137e+01 7.675682347126462446e+01 9.486164939905009419e+01 9.486164939905009419e+01 9.486164939905009419e+01 8.907929458861546834e+01 7.987226995532225260e+01 7.560747392903810749e+01 7.461030726255977186e+01 6.864661875761005660e+01 5.530132948171566909e+01 4.908544529942793133e+01
1.069387026374835870e+01 1.069387026374835870e+01 1.069387026374835870e+01 1.069387026374835870e+01 1.069387026374835870e+01 1.069387026374835870e+01 1.069387026374835870e+01 2.334865732325364363e+01 3.201528742034219732e+01 4.624398948143615939e+01 7.246594849008073425e+01 6.864661875761005660e+01 6.864661875761005660e+01 7.461030726255977186e+01 6.864661875761005660e+01 5.906737726124801213e+01 6.222008278464129916e+01 4.908544529942793133e+01 4.104466968598050869e+01 3.573299925653269327e+01 3.158492220220033175e+01 3.019638688553297712e+01
1.069387026374835870e+01 1.069387026374835870e+01 1.069387026374835870e+01 1.069387026374835870e+01 1.069387026374835870e+01 1.069387026374835870e+01 1.744811009413098546e+01 2.925805565722060209e+01 4.624398948143615939e+01 5.560900289945907815e+01 6.222008278464129916e+01 4.908544529942793133e+01 4.628349097089482456e+01 4.104466968598050869e+01 3.573299925653269327e+01 3.573299925653269327e+01 3.158492220220033175e+01 3.019638688553297712e+01 2.059497163885264115e+01 1.580826024707001665e+01 1.580826024707001665e+01 1.580826024707001665e+01
1.069387026374835870e+01 1.069387026374835870e+01 1.069387026374835870e+01 1.069387026374835870e+01 1.069387026374835870e+01 1.069387026374835870e+01 2.450435583765317915e+01 4.544290467840224323e+01 6.529169681758355637e+01 7.321425083654708033e+01 5.684871274836054766e+01 3.837954943437781452e+01 2.515177752063080163e+01 2.059497163885264115e+01 1.580826024707001665e+01 1.580826024707001665e+01 1.580826024707001665e+01 1.580826024707001665e+01 1.069387026374835870e+01 1.069387026374835870e+01 1.069387026374835870e+01 1.069387026374835870e+01
1.069387026374835870e+01 1.069387026374835870e+01 1.069387026374835870e+01 1.069387026374835870e+01 1.069387026374835870e+01 1.744811009413098546e+01 3.475507716969386252e+01 6.280681974623880137e+01 8.333575771516699149e+01 8.051937075894625195e+01 6.053924751424319339e+01 3.334662995605850000e+01 1.580826024707001665e+01 1.069387026374835870e+01 1.069387026374835870e+01 1.069387026374835870e+01 1.069387026374835870e+01 1.069387026374835870e+01 1.069387026374835870e+01 1.069387026374835870e+01 1.069387026374835870e+01 1.069387026374835870e+01
1.069387026374835870e+01 1.069387026374835870e+01 1.069387026374835870e+01 1.069387026374835870e+01 1.069387026374835870e+01 2.235416072387651454e+01 4.043229969978142435e+01 6.280681974623880137e+01 8.791687291272361904e+01 7.745554762834923679e+01 5.314043535137182772e+01 2.376624530054681372e+01 1.069387026374835870e+01 1.069387026374835870e+01 1.069387026374835870e+01 1.069387026374835870e+01 1.069387026374835870e+01 1.069387026374835870e+01 1.069387026374835870e+01 1.069387026374835870e+01 1.069387026374835870e+01 1.069387026374835870e+01
1.069387026374835870e+01 1.069387026374835870e+01 1.069387026374835870e+01 1.069387026374835870e+01 1.069387026374835870e+01 2.436660503380706899e+01 4.634129787921236243e+01 7.731550003203399513e+01 9.486164939905009419e+01 6.683493845984837378e+01 5.096751334541264100e+01 2.479223629683771080e+01 1.069387026374835870e+01 1.069387026374835870e+01 1.069387026374835870e+01 1.069387026374835870e+01 1.069387026374835870e+01 1.069387026374835870e+01 1.069387026374835870e+01 1.069387026374835870e+01 1.069387026374835870e+01 1.069387026374835870e+01
1.069387026374835870e+01 1.069387026374835870e+01 1.069387026374835870e+01 1.069387026374835870e+01 1.069387026374835870e+01 2.280717398950359609e+01 4.367883221646547298e+01 6.667537697573112609e+01 7.824784820606943470e+01 6.807835975089156477e+01 3.837954943437781452e+01 2.479223629683771080e+01 1.069387026374835870e+01 1.069387026374835870e+01 1.069387026374835870e+01 1.069387026374835870e+01 1.069387026374835870e+01 1.069387026374835870e+01 1.069387026374835870e+01 1.069387026374835870e+01 1.069387026374835870e+01 1.069387026374835870e+01
1.069387026374835870e+01 1.069387026374835870e+01 1.069387026374835870e+01 1.069387026374835870e+01 1.069387026374835870e+01 1.996668874766171342e+01 3.622550916134373722e+01 4.782280346197573806e+01 6.411129156920353012e+01 7.461030726255977186e+01 3.837954943437781452e+01 3.177088456233487435e+01 1.903266723126833782e+01 1.069387026374835870e+01 1.069387026374835870e+01 1.069387026374835870e+01 1.069387026374835870e+01 1.069387026374835870e+01 1.069387026374835870e+01 1.069387026374835870e+01 1.069387026374835870e+01 1.069387026374835870e+01
1.069387026374835870e+01 1.069387026374835870e+01 1.069387026374835870e+01 1.069387026374835870e+01 1.069387026374835870e+01 1.069387026374835870e+01 2.254587298193364830e+01 3.458787427178911145e+01 4.721788759764265819e+01 4.673027630677725597e+01 5.314043535137182772e+01 3.664717989033788115e+01 1.903266723126833782e+01 1.069387026374835870e+01 1.069387026374835870e+01 1.069387026374835870e+01 1.069387026374835870e+01 1.069387026374835870e+01 1.069387026374835870e+01 1.069387026374835870e+01 1.069387026374835870e+01 1.069387026374835870e+01
1.069387026374835870e+01 1.069387026374835870e+01 1.069387026374835870e+01 1.634513070875151897e+01 1.666252139879173555e+01 1.069387026374835870e+01 1.069387026374835870e+01 2.348606706422670243e+01 3.552509698059460419e+01 4.673027630677725597e+01 4.299730734831095447e+01 3.664717989033788115e+01 2.068457663231739829e+01 1.069387026374835870e+01 1.069387026374835870e+01 1.069387026374835870e+01 1.069387026374835870e+01 1.069387026374835870e+01 1.069387026374835870e+01 1.069387026374835870e+01 1.069387026374835870e+01 1.069387026374835870e+01
1.069387026374835870e+01 1.654713746148710385e+01 2.334865732325364363e+01 2.535741861672342878e+01 2.785563717741541012e+01 2.145374076571610900e+01 1.634513070875151897e+01 2.050493429340830076e+01 3.347254265532355078e+01 5.732141053195510239e+01 4.299730734831095447e+01 3.837954943437781452e+01 2.404202936817891612e+01 1.069387026374835870e+01 1.069387026374835870e+01 1.069387026374835870e+01 1.069387026374835870e+01 1.069387026374835870e+01 1.069387026374835870e+01 1.069387026374835870e+01 1.069387026374835870e+01 1.069387026374835870e+01
1.069387026374835870e+01 2.050493429340830076e+01 2.432440471747656829e+01 3.605425218644913343e+01 3.654695041814376566e+01 4.167470252386293339e+01 2.785563717741541012e+01 3.384692374235737589e+01 4.830820734801319105e+01 5.560900289945907815e+01 5.005075689286388041e+01 3.837954943437781452e+01 2.404202936817891612e+01 1.069387026374835870e+01 1.069387026374835870e+01 1.069387026374835870e+01 1.069387026374835870e+01 1.069387026374835870e+01 1.069387026374835870e+01 1.069387026374835870e+01 1.069387026374835870e+01 1.069387026374835870e+01
1.069387026374835870e+01 2.050493429340830076e+01 3.681851027804462717e+01 4.624398948143615939e+01 5.560900289945907815e+01 6.659787043424640274e+01 5.468192159319770695e+01 5.560900289945907815e+01 7.017441836656830390e+01 8.051937075894625195e+01 6.613217032068372703e+01 3.837954943437781452e+01 2.376624530054681372e+01 1.069387026374835870e+01 1.069387026374835870e+01 1.069387026374835870e+01 1.069387026374835870e+01 1.069387026374835870e+01 1.069387026374835870e+01 1.069387026374835870e+01 1.069387026374835870e+01 1.069387026374835870e+01
1.069387026374835870e+01 1.996668874766171342e+01 3.552509698059460419e+01 4.946052944489136394e+01 6.754050687637666783e+01 8.278403708311013531e+01 8.278403708311013531e+01 8.315774622338757638e+01 8.791687291272361904e+01 7.560747392903810749e+01 5.314043535137182772e+01 3.185174047389404706e+01 2.059497163885264115e+01 1.069387026374835870e+01 1.069387026374835870e+01 1.069387026374835870e+01 1.069387026374835870e+01 1.069387026374835870e+01 1.069387026374835870e+01 1.069387026374835870e+01 1.069387026374835870e+01 1.069387026374835870e+01
1.069387026374835870e+01 1.069387026374835870e+01 2.436660503380706899e+01 4.782280346197573806e+01 6.411129156920353012e+01 7.824784820606943470e+01 8.907929458861546834e+01 7.987226995532225260e+01 7.987226995532225260e+01 6.807835975089156477e+01 4.395411711245060360e+01 2.196882726471068636e+01 1.069387026374835870e+01 1.069387026374835870e+01 1.069387026374835870e+01 1.069387026374835870e+01 1.069387026374835870e+01 1.069387026374835870e+01 1.069387026374835870e+01 1.069387026374835870e+01 1.069387026374835870e+01 1.069387026374835870e+01
1.069387026374835870e+01 1.069387026374835870e+01 2.348606706422670243e+01 3.458787427178911145e+01 4.494844636469003518e+01 6.173758456449556320e+01 6.864661875761005660e+01 6.222008278464129916e+01 5.530132948171566909e+01 4.209226899357101814e+01 2.730456362592222774e+01 1.884738200731667490e+01 1.069387026374835870e+01 1.069387026374835870e+01 1.069387026374835870e+01 1.069387026374835870e+01 1.069387026374835870e+01 1.069387026374835870e+01 1.069387026374835870e+01 1.069387026374835870e+01 1.069387026374835870e+01 1.069387026374835870e+01
