1.062760487103778217e+01 1.062760487103778217e+01 1.062760487103778217e+01 1.062760487103778217e+01 1.062760487103778217e+01 1.062760487103778217e+01 1.062760487103778217e+01 1.062760487103778217e+01 1.062760487103778217e+01 1.062760487103778217e+01 1.062760487103778217e+01 1.062760487103778217e+01 1.062760487103778217e+01 1.062760487103778217e+01 1.062760487103778217e+01 1.062760487103778217e+01 1.062760487103778217e+01 1.062760487103778217e+01 1.062760487103778217e+01 1.062760487103778217e+01 1.062760487103778217e+01 1.062760487103778217e+01
1.062760487103778217e+01 1.062760487103778217e+01 1.062760487103778217e+01 1.062760487103778217e+01 1.062760487103778217e+01 1.062760487103778217e+01 1.062760487103778217e+01 1.062760487103778217e+01 1.062760487103778217e+01 1.062760487103778217e+01 1.656211186015514158e+01 1.900608373408609708e+01 1.900608373408609708e+01 2.135572126820171945e+01 2.135572126820171945e+01 2.305545341130770609e+01 2.305545341130770609e+01 2.021595906195119596e+01 1.062760487103778217e+01 1.062760487103778217e+01 1.062760487103778217e+01 1.062760487103778217e+01
1.062760487103778217e+01 1.062760487103778217e+01 1.062760487103778217e+01 1.062760487103778217e+01 1.062760487103778217e+01 1.062760487103778217e+01 1.062760487103778217e+01 1.062760487103778217e+01 1.062760487103778217e+01 1.900608373408609708e+01 2.272642128597962952e+01 3.088778749487455144e+01 3.653841334502905625e+01 3.653841334502905625e+01 3.653841334502905625e+01 3.668917225327861331e+01 3.668917225327861331e+01 2.792003008836952560e+01 2.112100310091644317e+01 1.062760487103778217e+01 1.062760487103778217e+01 1.062760487103778217e+01
1.062760487103778217e+01 1.062760487103778217e+01 1.062760487103778217e+01 1.062760487103778217e+01 1.062760487103778217e+01 1.062760487103778217e+01 1.062760487103778217e+01 1.629893998170607716e+01 2.348181438849669078e+01 3.126966347752177455e+01 4.123570614092379572e+01 5.151224669367431375e+01 5.360988623263199315e+01 5.360988623263199315e+01 5.360988623263199315e+01 5.360988623263199315e+01 5.483424525774733382e+01 3.750835489915669285e+01 2.878179404432587773e+01 1.906683777408682090e+01 1.062760487103778217e+01 1.062760487103778217e+01
1.062760487103778217e+01 1.062760487103778217e+01 1.062760487103778217e+01 1.062760487103778217e+01 1.062760487103778217e+01 1.062760487103778217e+01 1.629893998170607716e+01 2.300754592466191895e+01 3.232082144722591721e+01 4.919728919094608699e+01 6.380727012574756429e+01 5.977903114488825054e+01 5.743465482444803882e+01 5.743465482444803882e+01 5.302351201439437034e+01 5.743465482444803882e+01 6.278114224613620564e+01 5.360988623263199315e+01 3.555502952937794703e+01 2.068965660650491856e+01 1.062760487103778217e+01 1.062760487103778217e+01
1.062760487103778217e+01 1.062760487103778217e+01 1.062760487103778217e+01 1.062760487103778217e+01 1.062760487103778217e+01 1.062760487103778217e+01 2.300754592466191895e+01 3.523398715130635850e+01 4.919728919094608699e+01 6.380727012574756429e+01 5.743465482444803882e+01 5.728341817169241068e+01 4.108889643317800733e+01 4.100192139627583288e+01 4.403459868819304290e+01 5.302351201439437034e+01 7.000779893938107534e+01 5.193020984520835270e+01 4.017475178599606522e+01 1.906683777408682090e+01 1.062760487103778217e+01 1.062760487103778217e+01
1.062760487103778217e+01 1.062760487103778217e+01 1.062760487103778217e+01 1.062760487103778217e+01 1.062760487103778217e+01 1.900608373408609708e+01 2.921011339476787683e+01 4.919728919094608699e+01 6.380727012574756429e+01 6.108047994059295860e+01 5.250456937392975476e+01 3.866215875164099458e+01 2.703685485521691945e+01 2.355623191844375697e+01 3.370077118654121762e+01 4.669220876493616856e+01 5.977903114488825054e+01 5.193020984520835270e+01 4.017475178599606522e+01 1.906683777408682090e+01 1.062760487103778217e+01 1.062760487103778217e+01
1.062760487103778217e+01 1.062760487103778217e+01 1.062760487103778217e+01 1.062760487103778217e+01 1.062760487103778217e+01 2.234923796919274608e+01 4.644553669407854102e+01 6.501477632181733668e+01 7.145025987454479832e+01 4.846126440731492835e+01 4.043321033791429642e+01 2.126254427014812620e+01 1.862996725215564453e+01 2.976250296659715389e+01 3.790419621841178355e+01 6.380727012574756429e+01 6.306358253806044445e+01 4.846126440731492835e+01 3.057274840746227440e+01 1.906683777408682090e+01 1.062760487103778217e+01 1.062760487103778217e+01
1.062760487103778217e+01 1.062760487103778217e+01 1.062760487103778217e+01 1.062760487103778217e+01 1.746952669277943926e+01 3.235215935872516724e+01 5.189815474342468349e+01 6.777950708141023028e+01 6.335098824725917410e+01 5.193020984520835270e+01 3.026428963084898882e+01 2.618870555302718017e+01 3.126966347752177455e+01 4.633192310790022361e+01 6.501477632181733668e+01 5.977903114488825054e+01 6.335098824725917410e+01 4.421508082330727518e+01 2.377428092368428025e+01 1.411768470549884036e+01 1.062760487103778217e+01 1.062760487103778217e+01
1.062760487103778217e+01 1.062760487103778217e+01 1.062760487103778217e+01 1.062760487103778217e+01 1.746952669277943926e+01 2.965353835562357077e+01 5.730852893233635825e+01 7.000779893938107534e+01 6.452077936813341807e+01 5.193020984520835270e+01 4.139834038010302919e+01 4.123570614092379572e+01 4.999162775636807510e+01 6.501477632181733668e+01 6.380727012574756429e+01 6.335098824725917410e+01 4.421508082330727518e+01 3.158643443205587076e+01 1.930881759518094398e+01 1.062760487103778217e+01 1.062760487103778217e+01 1.062760487103778217e+01
1.062760487103778217e+01 1.062760487103778217e+01 1.062760487103778217e+01 1.062760487103778217e+01 2.105062897992335280e+01 3.218847632818508231e+01 5.956620707458916542e+01 7.362825023804266777e+01 7.174538477284657745e+01 5.716165586155302236e+01 6.009876391301578735e+01 6.009876391301578735e+01 7.017193168514502588e+01 7.752398993097169466e+01 7.145025987454479832e+01 5.177559908605517336e+01 3.109844946934862264e+01 2.059756021920894398e+01 1.062760487103778217e+01 1.062760487103778217e+01 1.062760487103778217e+01 1.062760487103778217e+01
1.062760487103778217e+01 1.062760487103778217e+01 1.062760487103778217e+01 1.062760487103778217e+01 1.062760487103778217e+01 2.437297576376334618e+01 4.403459868819304290e+01 5.302351201439437034e+01 6.900638035029629691e+01 6.335098824725917410e+01 7.000779893938107534e+01 6.652493916662287177e+01 7.752398993097169466e+01 8.403032843992511403e+01 6.466635262479873347e+01 4.299171655663895564e+01 2.059756021920894398e+01 1.062760487103778217e+01 1.062760487103778217e+01 1.062760487103778217e+01 1.062760487103778217e+01 1.062760487103778217e+01
1.062760487103778217e+01 1.062760487103778217e+01 1.062760487103778217e+01 1.062760487103778217e+01 1.062760487103778217e+01 2.116666946119428871e+01 3.550256102698680394e+01 4.850333764838433837e+01 5.141661074896552464e+01 5.743465482444803882e+01 7.000779893938107534e+01 7.929504699057991957e+01 8.684592840921604306e+01 7.408139922983758652e+01 5.502649077287107104e+01 3.057274840746227440e+01 1.930881759518094398e+01 1.062760487103778217e+01 1.062760487103778217e+01 1.062760487103778217e+01 1.062760487103778217e+01 1.062760487103778217e+01
1.062760487103778217e+01 1.062760487103778217e+01 1.062760487103778217e+01 1.062760487103778217e+01 1.062760487103778217e+01 1.062760487103778217e+01 2.324321849530623751e+01 2.937356560691632978e+01 3.458492957965538750e+01 4.669220876493616856e+01 5.797342249607441289e+01 7.752398993097169466e+01 7.145025987454479832e+01 6.466635262479873347e+01 3.882350826782019482e+01 2.196921211170429444e+01 1.062760487103778217e+01 1.062760487103778217e+01 1.062760487103778217e+01 1.062760487103778217e+01 1.062760487103778217e+01 1.062760487103778217e+01
1.062760487103778217e+01 1.062760487103778217e+01 1.062760487103778217e+01 1.062760487103778217e+01 1.062760487103778217e+01 1.062760487103778217e+01 1.062760487103778217e+01 2.116666946119428871e+01 2.382247826596352880e+01 4.669220876493616856e+01 6.652493916662287177e+01 7.752398993097169466e+01 6.141594349919029838e+01 4.421508082330727518e+01 2.554709563449646481e+01 1.930881759518094398e+01 1.062760487103778217e+01 1.062760487103778217e+01 1.062760487103778217e+01 1.062760487103778217e+01 1.062760487103778217e+01 1.062760487103778217e+01
1.062760487103778217e+01 1.062760487103778217e+01 1.062760487103778217e+01 1.062760487103778217e+01 1.062760487103778217e+01 1.062760487103778217e+01 1.062760487103778217e+01 1.746952669277943926e+01 2.951187062052770216e+01 5.189815474342468349e+01 6.777950708141023028e+01 7.145025987454479832e+01 5.177559908605517336e+01 3.109844946934862264e+01 2.059756021920894398e+01 1.062760487103778217e+01 1.062760487103778217e+01 1.062760487103778217e+01 1.062760487103778217e+01 1.062760487103778217e+01 1.062760487103778217e+01 1.062760487103778217e+01
1.062760487103778217e+01 1.062760487103778217e+01 1.062760487103778217e+01 1.062760487103778217e+01 1.062760487103778217e+01 1.062760487103778217e+01 1.062760487103778217e+01 2.450972669612315968e+01 3.932928555408608418e+01 6.501477632181733668e+01 7.145025987454479832e+01 6.090034100386655069e+01 3.882350826782019482e+01 2.059756021920894398e+01 1.062760487103778217e+01 1.062760487103778217e+01 1.062760487103778217e+01 1.062760487103778217e+01 1.062760487103778217e+01 1.062760487103778217e+01 1.062760487103778217e+01 1.062760487103778217e+01
1.062760487103778217e+01 1.062760487103778217e+01 1.062760487103778217e+01 1.062760487103778217e+01 1.062760487103778217e+01 1.062760487103778217e+01 2.300754592466191895e+01 3.347254265532355078e+01 5.189815474342468349e+01 6.777950708141023028e+01 6.466635262479873347e+01 4.421508082330727518e+01 2.554709563449646481e+01 1.062760487103778217e+01 1.062760487103778217e+01 1.062760487103778217e+01 1.656211186015514158e+01 1.900608373408609708e+01 1.900608373408609708e+01 1.062760487103778217e+01 1.062760487103778217e+01 1.062760487103778217e+01
1.062760487103778217e+01 1.062760487103778217e+01 1.062760487103778217e+01 1.062760487103778217e+01 1.062760487103778217e+01 1.746952669277943926e+01 3.189899771131404549e+01 5.189815474342468349e+01 6.380727012574756429e+01 6.335098824725917410e+01 4.846126440731492835e+01 3.057274840746227440e+01 2.009397188794036637e+01 1.062760487103778217e+01 1.062760487103778217e+01 1.746952669277943926e+01 2.348181438849669078e+01 2.618870555302718017e+01 2.112100310091644317e+01 2.112100310091644317e+01 1.062760487103778217e+01 1.062760487103778217e+01
1.062760487103778217e+01 1.062760487103778217e+01 1.062760487103778217e+01 1.062760487103778217e+01 1.062760487103778217e+01 2.234923796919274608e+01 3.932928555408608418e+01 6.652493916662287177e+01 7.145025987454479832e+01 5.557841889487946219e+01 3.109844946934862264e+01 2.196921211170429444e+01 1.062760487103778217e+01 1.062760487103778217e+01 1.062760487103778217e+01 2.105062897992335280e+01 2.746157501403398271e+01 2.716749804884702613e+01 3.750835489915669285e+01 2.289678466280058089e+01 2.068965660650491856e+01 1.062760487103778217e+01
1.062760487103778217e+01 1.062760487103778217e+01 1.062760487103778217e+01 1.062760487103778217e+01 1.746952669277943926e+01 2.432440471747656829e+01 5.030158609100872980e+01 5.977903114488825054e+01 6.090034100386655069e+01 4.299171655663895564e+01 2.613463092226445994e+01 1.062760487103778217e+01 1.062760487103778217e+01 1.062760487103778217e+01 1.062760487103778217e+01 2.105062897992335280e+01 2.989171542845337370e+01 3.695733556703524414e+01 3.777914535122418016e+01 2.416959183280359014e+01 2.068965660650491856e+01 1.062760487103778217e+01
1.062760487103778217e+01 1.062760487103778217e+01 1.062760487103778217e+01 1.062760487103778217e+01 1.746952669277943926e+01 2.965353835562357077e+01 4.669220876493616856e+01 4.837278337803826389e+01 4.421508082330727518e+01 2.554709563449646481e+01 2.009397188794036637e+01 1.062760487103778217e+01 1.062760487103778217e+01 1.062760487103778217e+01 1.062760487103778217e+01 2.105062897992335280e+01 2.324321849530623751e+01 2.574313510535947813e+01 2.804995354159927956e+01 2.316133377554944417e+01 2.059756021920894398e+01 1.062760487103778217e+01
